100
100
PPPPPPPPPPPPPPPPPPPPPPPPPPPPPPPPPPPPPPPPPPPPPPPPPPPPPPPPPPPPPPPPPPPPPPPPPPPPPPPPPPPPPPPPPPPPPPPPPPPP
PPPPPPPPPPPPPPPPPPPPPPPPPPPPPPPPPPPPPPPPPPPPPPPPPPPPPPPPPPPPPPPPPPPPPPPPPPPPPPPPPPPPPPPPPPPPPPPPPPPP
PPPPPPPPPPPPPPPPPPPPPPPPPPPPPPPPPPPPPPPPPPPPPPPPPPPPPPPPPPPPPPPPPPPPPPPPPPPPPPPPPPPPPPPPPPPPPPPPPPPP
PPPAAAAAAAAAAAAAAAAAAAAAAAAAAAAAAAAAAASSAAAAAAAAAASSAAAASSAAAAAAAAAAAAAAAAAAAASSAAAAASSAAAAASSASSPPP
PPPAAAAAAAAAAAAAAAAAAAAAAAAASAAAAAAAAAASSAAAAAAAASSSSASSSSAAAAAAAAAAAAAAAAAAAASSAAAAASSAAAASSASSAPPP
PPPAAAAAAAAAAAAAAAAAAAAAAASSSSAAAAAAAAASSAAAAAAAASSSSSSSAAAAAAAAAAAAAAAAAAAAASSAAAAASSAAAAAASSAAAPPP
PPPAAAAAAAAAAAAAAAAAAAAASSSSASSSSAAASASSSASASSASSSSAASAAAAAAAAAAAAAAAAAAAAAAAASSAAAASSAAAAAAASSAAPPP
PPPAAAAAAAAAAAAAAAAAAAASSSAAAASSSSSSSSSSASKSSSSSSASSAAAAAAAAAAAAAAAAAAAAAAAAAASSAAAAASSAAAAAASSAAPPP
PPPAAAAAAAAAAASAAAAAASSSAAAAAAAAASSSASASSSASAASAASSAAAAAAAAAAAAAAAAAAAAAAAAAAAASSAAASSAAAAAAASSAAPPP
PPPAAAAAAAAAASSSASSSSSSAAAAAAAAAAAAAAAAASAAAAAAAAASSAAAAAAAAAAAAAAAAAAAAAAAAAAASSAASSAAAAAAAAASSAPPP
PPPAAASSAAAASSASSSSSSAAAAAAAAAAAAAAAAAAASSAAAAAAAAASSAAAAAAAAAAAAAAAAAAAAAAAAAAASSASSAAAAAAAASSSSPPP
PPPSASSSSASSSAAASAAAAAAAAAAAAAAAAAAAAAAASSAAAAAAAAASSAAAAAAAAAAAAAAAAAAAAAAAAAAASSAASSAAAAAAAASSAPPP
PPPSSSAASSSSAAAAAAAAAAAAAAAAAAAAAAAAAAAASSAAAAAAAASSAAAAAAAAAAAAAAAAAAAAAAAAAAAAASSSSSSSSSSSSSSSAPPP
PPPASAAAASAAAAAAAAAAAAAAAAAAAAAAAAAAAAAAASSAAAAAAAASSAAAAAAAAAAAAAAAAAAAAAAAAAAASSASSSMMMMMMMMMSAPPP
PPPAAAAAAAAAAAAAAAAAAAAAAAAAAAAAAAAAAAAAAASSAAAAAAASSAAAAAAAAAAAAAAAAAAAAAAAAAASSAAAASMSSSSSSSMSAPPP
PPPAAAAAAAAAAAAAAAAAAAAAAAAAAAAAAAAAAAAAAASSAAAAAASSAAAAAAAAAAAAAAAAAAAAAAAAAAAAAAAAASMSSSSSSSMSAPPP
PPPAAAAAAAAAAAAAAAAAAAAAAAAAAAAAAAAAAAAAAAASSAAAAASSAAAAAAAAAAAAAAAAAAAAAAAAAAAAAAAAASMSSSSSSSMSAPPP
PPPAAAAAAAAAAAAAAAAAAAAAAAAAAAAAAAAAAAAAAAASSAAAAASSAAAAAAAAAAAAAAAAAAAAAAAAAAASSAAAASMSSSSSSSMSAPPP
PPPAAAAAAAAAAAAAAAAAAAAAAAAAAAAAAAAAAAAAAASSAAAAAASSAAAAAAAAAAAAAAAAAAAAAAAAAAAASSAAASMSSSSSSSSSAPPP
PPPAAAAAAAAAAAAAAAAAAAAAAAAAAAAAAAAAAAAAAASSAAAAAAASSAAAAAAAAAAAAAAAAAAAAAAAAAAAASSAASMSSSSSSSMSAPPP
PPPAAAAAAAAAAAAAAAAAAAAAAAAAAAAAAAAAAAAAASSAAAAAAAASSAAAAAAAAAAAAAAAAAAAAAAAAAAAASSAASMSSSSSSSMSAPPP
PPPAAAAAAAAAAAAAAAAAAAAAAAAAAAAAAAAAAAAAAASSAAAAAAAASSAAAAAAAAAAAAAAAAAAAAAAAAAASSAAASMMMSMMMMMSAPPP
PPPAAAAAAAAAAATTTTTTTAAAAAAAAAAAAAAAAAAAAAASSAAAAAASSAAAAAAAAAAAAAAAAAAAAAAAAAAAASSAASSSSSSSSSSSAPPP
PPPAAAAAAAAAATTTTTTTTTAAAAAAAAAAAAAAAAAAAASSAAAAAASSAAAAAAAAAAAAAAAAAAAAAAAAAAAAASSASSAAAAAAAASSAPPP
PPPAAAAAAAAAATTTTTTTTTAAAAAAAAAAAAAAAAAAAAASSAAAAAASSAAAAAAAAAAAAAAAAAAAAAASSSSSSSSSSSAAAAAAASSAAPPP
PPPAAAAAAAAAATTTTTTTTTAAAAAAAAAAAAAAAAAAAAASSAAAAAASSAAAAAAAAAAAAAAAAAAAAAASMMMMMMMMMSAAAAAAASSAAPPP
PPPAAAAAAAAAATTTTTTTTTAAAAAAAAAAAAAAAAAAAAAASSAAAAASSAAAAAAAAAAAAAAAAAAAAAASMSSSSSSSSSAAAAAAAASSAPPP
PPPAAAAAAAAAATTTTTTTTTAAAAAAAAAAAAAAAAAAAAAAASSAAAASSAAAAAAAAAAAAAAAAAAAAAASMSSSSSSSMSAAAAAAAASSAPPP
PPPAAAAAAAAAATTTTTTTTTAAAAAAAAAAAAAAAAAAAAAAAASSAAASSAAAAAAAAAAAAAAAAAAAAAASMSSSSSSSMSAAAAAAASSAAPPP
PPPAAAAAAAAAATTTTTTTTTAAAAAAAAAAAAAAAAAAAAAAASSAAASSAAAAAAAAAAAAAAAAAAAAAAASMSSSSSSSMSAAAAAAAASSAPPP
PPPAAAAAAAAAATTTTTTTTTAAAAAAAAAAAAAAAAAAAAAAASSAAASSAAAAAAAAAAAAAAAAAAAAAAASMSSSSSSSMSAAAAASAASSAPPP
PPPAAAAAAAAAATTTTTTTTTAAAAAAAAAAAAAAAAAAAAAAASSAAAASSAAAAAAAAAAAAAAAAAAAAAASSSSSSSSSMSAAASSSSSSSSPPP
PPPAAAAAAAAAATTTTTTTTTAAAAAAAAAAAAAAAAAAAAAAASSAAAAASSAAAAAAAAAAAAAAAAAAAAASMSSSSSSSMSAASSSASSSAAPPP
PPPAAAAAAAAAATTTTTTTTTAAAAAAAAAAAAAAAAAAAAAAAASSAAAAASSAAAAAAAAAAAAAAAASASSSMMMMMMMMMSSSSAAAASSAAPPP
PPPAAAAAAAAAATTTTTTTTTAAAAAAAAAAAAAAAAAAAAAAASSAAAAAASSAAAAAAAAAAAAAASSSSSSSSSSSSSSSSSSSAAAASSAAAPPP
PPPSSAAAASSSAATTTTTTTAAAAAAAAAAAAAAAAAAAAAAAASSAAAAAAASSAAAAAAAAAAAASSSASAAAAAAAAASSSSAAAAAAASSAAPPP
PPPSSSAASSSSSSSSSSSAASSAAAAAAASAAAAAAAAAAAAASSAAAAAAASSAAAAAAAAAAAASSAAAAAAAAAAAAASSSSAAAAAAASSAAPPP
PPPAASSSSAAASAASSSSSSSSSSSASSSSSSASAAAAAAAAASSSAAAAAAASSAAAAAAAASASSAAAAAAAAAAAAASSAASSAAAAAAASSAPPP
PPPAAASSAAAAAAAAAAASSAASSSSSSSASSSSSSASASAASSSSSAAAAAAASSAAASAASSSSAAAAAAAAAAAAAAASSSSAAAAAAASSAAPPP
PPPAAAAAAAAAAAAAAAAAAAAAAASAAAAAASASSSSSSSSSSSASSSSSSASSAASSSSSSASAAAAAAAAAAAAAAAAAASSAAAAAAASSAAPPP
PPPAAAAAAAAAAAAAAAAAAAAAAAAAAAAAAAAAASASASSSSAAASSSSSSSSASSSASSAAAAAAAAAAAAAAAAAAAASSSSAAAAASSAAAPPP
PPPAAAAAAAAAAAAAAAAAAAAAAAAAAAAAAAAAAAAAAASSAAAAAAAAASBSSSBBBBBBBBBBAAAAAAAAAAAAAAAASSAAAAAAASSAAPPP
PPPAAAAAAAAAAAAAAAAAAAAAAAAAAAAAAAAAAAAAASSAAAAASSSSSSSSSSSBBBBBBBBBAAAAAAAAABBBBBBBSSBBBAAAAASSAPPP
PPPAAAAAAAAAAAAAAAAAAAAAAAAAAAAAAAAAAAAAAASSAAAASMMMMMMSMMSBBBBBBBBBAAAAAAAAABBBBBBBSSBBBAAAASSAAPPP
PPPAAAAAAAAAAAAAAAAAAAAAAAAAAAAAAAAAAAAAAAASSAAASMSSSSSSSMSBBBBBBBBBBBAABBBBBBBBBBBSSSSBBAAASSAAAPPP
PPPAAAAAAAAAAAAAAAAAAAAAAAAAAAAAAAAAAAAAAASSAAAASMSSSSSSSMSBBBBBBBBBBBBAABBBBBBBBBBSSBSSBAASSAAAAPPP
PPPAAAAAAAAAAAAAAAAAAAAAAAAAAAAAAAAAAAAAASSDAAAASMSSSSSSSMSBBBBBBBBBBBBAABBBBBBBBBSSBBBSSAAASSAAAPPP
PPPAAAAAAAAAAAAAAAAAAAAAAAAAAAAAAAAAAAAAAASSAAAASMSSSSSSSMSBBBBBBBBBBBBBAABBBBBBBBBSSBBSSAAASSAAAPPP
PPPAAAAAAAAAAAAAAAAAAAAAAAAAAAAAAAAAAAAAAAASSAAASMSSSSSSSMSBBBBBBBBBBBBBAABBBBBBBBSSBBBSSAAAASSAAPPP
PPPAAAAAAAAAAAAAAAAAAAAAAAAAAAAAAAAAAAAAAAASSAAASMSSSSSSSMSBBBBBBBBBBBBAABBBBBBBBBSSBBBSSAAAAASSAPPP
PPPAAAAAAAAAAAAAAAAAAAAAAAAAAAAAAAABBBBBBBSSBBBBSMSSSSSSSMSBBBBBBBBBBBBBAABBBBBBBBSSBBBSSAAAAAASSPPP
PPPAAAAAAAAAAAAAAAAAAAAAAAAAAAAASAABBBBBBBBSSBBBSMMMMMMMMMSBBBBBBBBBBBBBBAABBBBBBBBSSBSSBAAAAAASSPPP
PPPAAAAAAAAAAAAAAAAAAAAAAAAAASASSSASBBBBBBSSBBBBSSSSSSSSSSSBBBBBBBBBBBBBBAABBBBBBBBBSSSSBAAAAAASSPPP
PPPAAAAAAAAAAAAAAAAAAAASSASSSSDSASSSSSBSBSSBSBBBBAAAAABBSSBBBBBBBBSBBBBBAABBBBBBBBSBBSSBBASSSSSASPPP
PPPASAAAAAAAAAAAAAAAASSSSSSSSASAAASBSSSSSBBSSSSBBASASABBBSSBBSBSBSSSBBBAABBBBABBBSSSSSASASSSSSSSSPPP
PPPSSSAABSBBBBSSSBAASSSAASAAAAAAAAABBBSBSSSSBSSSBSSSSSAAASSASSSSSSASSBBBSBBSSSSSSSBSASSSSSAAAAASAPPP
PPPSASSASSSSSSSSSSSSSAAAAAAAAAAAAAABBBBBBSSBBBBSSSASASSSASSSSASASAAASSSSSSSSSSSSSBBBSSAASAAAAAAAAPPP
PPPSASSSSSSSSSSBBSSSAAAAAAAAAAAAAAABBBBBSSBBBBBBSAAAAASSSSASAAAAASASSSSSBSSSBBBBBBBBASAAAAAAAAAAAPPP
PPPSSSASBSBBBBSSBBAAAAAAAAAAAAAAAAABBBBSSBBBBBBBBAAAAAASSAAAAAAASSSSSBBBAABSSBBBSBBBSSSAAASSAAAAAPPP
PPPASAAABBBBBBBSSSAAAAAAAAAAAAAASAABBBBBSSBBBBBBBAAAAAAASSAAAAASSASABBBBBAABSSBSSSBSSASSSSSSSAAAAPPP
PPPAAAAABBBBBBBBSSSAAAAAAAASSASSSSABBBBBBSSBBBBBBAAAAASASSAAASSSAAAAAAAAAAAAASSSASSSSSASSSAASSAAAPPP
PPPAAAAABBBBBBBBBBSSASSSAASSSSSSASSBBBBBSSBBBBBBBAAAASSSASSASSSSAAAAAAAAAAAAAASAAASAASSAAAAAASSASPPP
PPPAAAAABBBBBBBBBBASSSSSSSSAASAAAASSBBBBBSSBSSBBBSAASSASSSSSSSSSSSAAASSSAASSASSASSAAASSASAASSASSSPPP
PPPAAAAABBBBBBBBBBAASAAASSAAAAAAAAASSSSSSSBSSSBSSSSSSSSASSSSSSSASSSSSSSSAASSSSSSSSSSASSSSSSSSAASSPPP
PPPAAAAABBBBBBBBBBAAAAAAAAAAAAAAAAAASSSSASSSAASSSASSASSSASSSSAAAAASSSAAAAAAASAASAASSSSKSASSAAAAASPPP
PPPAAAAAAAAAAAAAAAAAAAAAAAAAAAAAAAAAAAAAASSAASSAAAAAAAASSSASAAAAAAAAAAAAAAAAAAAAAAAASSSAAAAAAAAAAPPP
PPPAAAAAAAAAAAAAAAAAAAAAAAAAAAAAAAAAAAAAASSSSSAAAAAAAAASSAAAAAAAAAAAAAAAAAAAAAAAAAAAAASSAAAAAAAAAPPP
PPPAAAAAAAAAAAAAAAAAAAAAAAAAAAAAAAAAAAAAABSSSBBBBBBBBBBBSSAAAAAAAAAAAAAAAAAAAAAAAAAAASSSSAAAAAAAAPPP
PPPASAAAAAAAAAAAAAAAAAAAAAAAAAAAAAAAAAAAASSBBBBBBBBBBBBSSAAAAAAAAAAAAAAAAAAAAAAAAAAAAASSAAAAAAAAAPPP
PPPSSSSAAAAAAAAAAAAAAAAAAAAAAAAAAAAAAAAASSSSBBBBBBBBBBBBSSAAAAAAAAAAAAAAAAAAAAAAAAAAASSAAAAAAAAAAPPP
PPPSASSSASASAAAAAAAAAAAAAAAAAAAASAAAAASSSKSSBBBBBBBBBBBSSAAAAAAAAAAAAAAAAAAAAAAAAAAASSSSAAAAAAAAAPPP
PPPAAAASSSSSSAASSSSSSSSSSSSSAAASSSSASSSSASSBBBBBBBBBBBBSSAAAAAAAAAAAAAAAAAAAAAAAAAAAASSAAAAAAAAAAPPP
PPPAAAAASASASSSSMMMMMMMMMSSSSSSSASSSSSAASSBBBBBBBBBBBBBSSAAAAAAAAAAAAAAAAAAAAAAAAAAAASSAAAAAAAAAAPPP
PPPAAAAAAAAAASSSMSSSSSSSMSAASSSAAAASAAASSBBBBBBBBBBBBBBSSAAAAAAAAAAAAAAAAAAAAAAAAAAAASSAAAAAAAAAAPPP
PPPAAAAAAAAAAAASMSSSSSSSMSAAAAAAAAAAAAASSBBBBBBBXBBBBBSSBAAAAAAAAAAAAAAAAAAAAAAAAAAAASSAAAAAAAAAAPPP
PPPAAAAAAAAAAAASMSSSSSSSMSAAAAAAAAAAAAAASSBBBBBBBBBBBSSBBAAAAAAAAAAAAAAAAAAAAAAAAAAAAASSAAAAAAAAAPPP
PPPAAAAAAAAAAAASSSSSSSSSSSAAAAAAAAAAAAASSBBBBBBBBBBBSSBBBAAAAAAAAAAAAAAAAAAAAAAAAAAAASSAAAAAAAAAAPPP
PPPAAAAAAAAAAAASMSSSSSSSMSAAAAAAAAAAAAASSBBBBBBBBBBBBSSBBAAAAAAAAAAAAAAAAAAAAAAAAAAASSAAAAAAAAAAAPPP
PPPAAAAAAAAAAAASMSSSSSSSMSAAAAAAAAAAAASSABBBBBBBBBBBBBSSBAAAAAAAAAAAAAAAAAAAAAAAAAAASSAAAAAAAAAAAPPP
PPPAAAAAAAAAAAASMSSSSSSSMSAAAAAAAAAAASSAAABBBBBBBBBBBSSBBAAAAAAAAAAAAAAAAAAAAAAAAAAAASSAAAAAAAAAAPPP
PPPAAAAAAAAAAAASMMMMMMMMMSAAAAAAAAAAASSAABBBBBBBBBBBBBSSBAAAAAAAAAAAAAAAAAAAAAAAAAAAAASSAAAAAAAAAPPP
PPPAAAAAAAAAAAASSSSSSSSSSSAAAAAAAAAASSAAABBBBBBBBBBBBBSSBAAAAAAAAAAAAAAAAAAAAAAAAAAAASSAAAAAAAAAAPPP
PPPAAAAAAAAAAAAAAAAAAAAAAAAAAAAAAAAASSAAABBBBBBBBBBBBSSBBAAAAAAAAAAAAAAAAAAAAAAAAAAAASSAAAAAAAAAAPPP
PPPAAAAAAAAAAAAAAAAAAAAAAAAAAAAAAAAASSAAAAAAAAAAAAAASSAAAAAAAAAAAAAAAAAAAAAAAAAAAAAAASSAAAAAAAAAAPPP
PPPAAAAAAAAAAAAAAAAAAAAAAAAAAAAAASSSSSSSSSSSAAAAAAASSAAAAAAAAAAAAAAAAAAAAAAAAAAAAAAAASSAAAAAAAAAAPPP
PPPAAAAAAAAAAAAAAAAAAAAAAAAAAAAAASMSMMMMMMMSAAAAAAAASSAAAASAAAAAAAAAAAAAAAAAAAAAAAAAAASSAAAAAAAAAPPP
PPPASAAAAAAAAAAAAAAAAAAAAAAAAASSSSMSSSSSSSMSASAAASASASSSASSSASAAAAAAAAAAAAAAAASSAAAAASSAAAAAAAAAAPPP
PPPSSSAAAAAAAAAAAAAAAAAAAASASSSSSSMSSSSSSSMSSSSASSSSSSASSSASSSSAAAAAAAAASAAAASSSSAAAAASSAAAAAAAAAPPP
PPPSASSSAAAAAAAASAAAAAAAASSSSSAAASMSSSSSSSMSSASSSASSSAAASAAASASSSASSAAASSSAASSAASSAAASSSSAAAASASAPPP
PPPAAASSSAAAAASSSSASAAAASSASAAAAASMSSSSSSSMSAAASAAASSAAAAAAAAAASSSSSSSSSASSSSAAAASSAAASSSSSSSSSSSPPP
PPPAAAAASSSASSSSASSSSSASSAAAAAAAASMSSSSSSSMSAAAAAASSAAAAAAAAAAAAASAASSSAAASSAAAAAASSASSSSSSSSASASPPP
PPPAAAAAASSSSSAAAASASSSSAAAAAAAAASMSSSSSSSMSAAAAASSAAAAAAAAAAAAAAAAAAAAAAAAAAAAAAAASSSSSSSAAAAAAAPPP
PPPAAAAAAAASAAAAAAAAAASAAAAAAAAAASMSSSSSSSMSAAAAASSAAAAAAAAAAAAAAAAAAAAAAAAAAAAAAAAASASSSSAAAAAAAPPP
PPPAAAAAAAAAAAAAAAAAAAAAAAAAAAAAASMMMMMMSMMSAAAAAASSAAAAAAAAAAAAAAAAAAAAAAAAAAAAAAAAASSASSAAAAAAAPPP
PPPAAAAAAAAAAAAAAAAAAAAAAAAAAAAAASSSSSSSSSSSAAAAASSAAAAAAAAAAAAAAAAAAAAAAAAAAAAAAAAASSASSAAAAAAAAPPP
PPPAAAAAAAAAAAAAAAAAAAAAAAAAAAAAAAASSAAAAAAAAAAAAASSAAAAAAAAAAAAAAAAAAAAAAAAAAAAAAASSASSAAAAAAAAAPPP
PPPAAAAAAAAAAAAAAAAAAAAAAAAAAABBBBBBSSBBAAAAAAAAAAASSAAAAAAAAAAAAAAAAAAAAAAAAAAAAASSAAASSAAAAAAAAPPP
PPPPPPPPPPPPPPPPPPPPPPPPPPPPPPPPPPPPPPPPPPPPPPPPPPPPPPPPPPPPPPPPPPPPPPPPPPPPPPPPPPPPPPPPPPPPPPPPPPPP
PPPPPPPPPPPPPPPPPPPPPPPPPPPPPPPPPPPPPPPPPPPPPPPPPPPPPPPPPPPPPPPPPPPPPPPPPPPPPPPPPPPPPPPPPPPPPPPPPPPP
PPPPPPPPPPPPPPPPPPPPPPPPPPPPPPPPPPPPPPPPPPPPPPPPPPPPPPPPPPPPPPPPPPPPPPPPPPPPPPPPPPPPPPPPPPPPPPPPPPPP
