75
75
PPPPPPPPPPPPPPPPPPPPPPPPPPPPPPPPPPPPPPPPPPPPPPPPPPPPPPPPPPPPPPPPPPPPPPPPPPP
PPPPPPPPPPPPPPPPPPPPPPPPPPPPPPPPPPPPPPPPPPPPPPPPPPPPPPPPPPPPPPPPPPPPPPPPPPP
PPPPPPPPPPPPPPPPPPPPPPPPPPPPPPPPPPPPPPPPPPPPPPPPPPPPPPPPPPPPPPPPPPPPPPPPPPP
PPPAAAAAAAAXAAAAAAAAAAAAAAAPPPPPPPPPPPPPPPPPPPPBBBBBBBBBBXBBBBBBBBBBBBBBPPP
PPPAAAAAAAAAAAAAAAAAAAAAAAAPPPPPPPPPPPPPPPPPPPPBBBBBBBBBBBBBBBBBBBBBBBBBPPP
PPPAAAAAAAAAAAAAAAAAAAAAAAADDDDDDDDDDDDDDDDDDDDBBBBBBBBBBBBBBBBBBBBBBBBBPPP
PPPAAAAAAAAAAAAAAAAAAAAAAAADDDDDDDDDDDDDDDDDDDDBBBBBBBBBBBBBBBBBBBBBBBBBPPP
PPPAAAAAAAAAAAAAAAAAAAAAAAAPKKPPPPPPPPPPPPPPPPPBBBBBBBBBBBBBBBBBBBBBBBBBPPP
PPPAAAAAAAAAAAAAAAAAAAAAAAAPKKKKKKKKKKKKKKKKKKPBBBBBBBBBBBBBBBBBBBBBBBBBPPP
PPPAAAAAAAAAAAAAAAAAAAAAAAAPKKKKKKKKKKKKKKKKKKPBBBBBBBBBBBBBBBBBBBBBBBBBPPP
PPPAAAAAAAAAAAAAAAAAAAAAAAAPPPPPPPPPPPPPPPPPPKKBBBBBBBBBBBBBBBBBBBBBBBBBPPP
PPPAAAAAAAAAAAAAAAAAAAAAAAAPKKKKKKKKKKKKKKKKKKPBBBBBBBBBBBBBBBBBBBBBBBBBPPP
PPPAAAAAAAAAAAAAAAAAAAAAAAAPKKKKKKKKKKKKKKKKKKPBBBBBBBBBBBBBBBBBBBBBBBBBPPP
PPPAAAAAAAAAAAAAAAAAAAAAAAAPKKPPPPPPPPPPPPPPPPPBBBBBBBBBBBBBBBBBBBBBBBBBPPP
PPPAAAAAAAAAAAAAAAAAAAAAAAAPKKKKKKKKKKKKKKKKKKPBBBBBBBBBBBBBBBBBBBBBBBBBPPP
PPPAAAAAAAAAAAAAAAAAAAAAAAAPKKKKKKKKKKKKKKKKKKKBBBBBBBBBBBBBBBBBBBBBBBBBPPP
PPPAAAAAAAAAAAAAAAAAAAAAAAAPPPPPPPPPPPPPPPPPKKPBBBBBBBBBBBBBBBBBBBBBBBBBPPP
PPPAAAAAAAAAAAAAAAAAAAAAAAAKKKKKKKKKKKKKKKKKKKPBBBBBBBBBBBBBBBBBBBBBBBBBPPP
PPPAAAAAAAAAAAAAAAAAAAAAAAAKKKKKKKKKKKKKKKKKKKPBBBBBBBBBBBBBBBBBBBBBBBBBPPP
PPPAAAAAAAAAAAAAAAAAAAAAAAAPPPPPPPPPPPPPPPPPPPPBBBBBBBBBBBBBBBBBBBBBBBBBPPP
PPPAAAAAAAAXAAAAAAAAAAAAAAAPPPPPPPPPPPPPPPPPPPPBBBBBBBBBBXBBBBBBBBBBBBBBPPP
PPPPPPPPPXXXPPPPPPPPPPPPPPPPPPPPPPPPPPPPPPPPPPPPPPPPPPPPPXXXPPPPPPPPPPPPPPP
PPPPPPPPPXXXPPPPPPPPPPPPPPPPPPPPPPPPPPPPPPPPPPPPPPPPPPPPPXXXPPPPPPPPPPPPPPP
PPPPPPPPPXXXPPPPPPPPPPPPPPPPPPPPPPPPPPPPPPPPPPPPPPPPPPPPPXXXPPPPPPPPPPPPPPP
PPPPPPPPPXXXPPPPPPPPPPPPPPPPPPPPPPPPPPPPPPPPPPPPPPPPPPPPPXXXPPPPPPPPPPPPPPP
PPPPPPPPPXXXPPPPPPPPPPPPPPPPPPPPPPPPPPPPPPPPPPPPPPPPPPPPPXXXPPPPPPPPPPPPPPP
PPPPPPPPPXXXPPPPPPPPPPPPPPPPPPPPPPPPPPPPPPPPPPPPPPPPPPPPPXXXPPPPPPPPPPPPPPP
PPPPPPPPPXXXPPPPPPPPPPPPPPPPPPPPPPPPPPPPPPPPPPPPPPPPPPPPPXXXPPPPPPPPPPPPPPP
PPPPPPPPPXXXPPPPPPPPPPPPPPPPPPPPPPPPPPPPPPPPPPPPPPPPPPPPPXXXPPPPPPPPPPPPPPP
PPPPPPPPPXXXPPPPPPPPPPPPPPPPPPPPPPPPPPPPPPPPPPPPPPPPPPPPPXXXPPPPPPPPPPPPPPP
PPPPPPPPPXXXPPPPPPPPPPPPPPPPPPPPPPPPPPPPPPPPPPPPPPPPPPPPPXXXPPPPPPPPPPPPPPP
PPPPPPPPPXXXPPPPPPPPPPPPPPPPPPPPPPPPPPPPPPPPPPPPPPPPPPPPPXXXPPPPPPPPPPPPPPP
PPPXXXXXXXXXXXXXXXXXXXXXXXXXXXXXXBBBBBXXXXXXXXXXXXXXXXXXXXXXXXXXXXXXXXXXPPP
PPPXXXXXXXXXXXXXXXXXXXXXXXXXXXXXXBBBBBXXXXXXXXXXXXXXXXXXXXXXXXXXXXXXXXXXPPP
PPPXXXXXXXXXXXXXXXXXXXXXXXXXXXXXXBBBBBXXXXXXXXXXXXXXXXXXXXXXXXXXXXXXXXXXPPP
PPPDDDDDDDDDKDDDDDDDDDDXXXXXXXXXXBBBBBXXXXXXXXXXDDDDDDDDDDDDDKDDDDDDDDDDPPP
PPPAAAAAAAAAAAAAAAAAAAAMMMMMMMMMMMDDDMMMMMMMMMMMAAAAAAAAAAAAAAAAAAAAAAAAPPP
PPPAAAAAAAAAAAAAAAAAAAAMDDDDDDDDDDDDDDDDDDDDDDDMAAAAAAAAAAAAADDDDDDDDAAAPPP
PPPAAAAAAAAADAAAAAAAAAAMDDDDDDDDDDDDDDDDDDDDDDDMAAAAAAAAAAAAAAAAAAAADAAAPPP
PPPAAAAAAAAADAAAAAAAAAAMMMMMMMMMMMMMMMMMMMMMMDDMAAAAAAAAAAAAAAAAAAAADAAAPPP
PPPAAAAAAAAADDDDAAAAAAAMDDDDDDDDDDDDDDDDDDDDDDDMAAAAAAAAAAAAAAAAAAAADAAAPPP
PPPAAAAAAAAAAAADAAAAAAAMDDDDDDDDDDDDDDDDDDDDDDDMAAAADDDDDDDDDDDDDDDDDAAAPPP
PPPAAAAAAAAADDDDAAAAAAAMDDMMMMMMMMMMMMMMMMMMMMMMAAAADAAAAAAAAAAAAAAAAAAAPPP
PPPAAAAAAAAADAAAAAAAAAAMDDDDDDDDDDDDDDDDDDDDDDDMAAAADAAAAAAAAAAAAAAAAAAAPPP
PPPAAAAAAAAADDDDAAAAAAAMDDDDDDDDDDDDDDDDDDDDDDDMAAAADAAAAAAAAAAAAAAAAAAAPPP
PPPAAAAAAAAAAAADAAAAAAAMMMMMMMMMMMMMMMMMMMMMMDDMAAAADAAAAAAAAAAAAAAAAAAAPPP
PPPAAAAAAAAADDDDAAAAAAAMDDDDDDDDDDDDDDDDDDDDDDDMAAAADAAAAAAAAAAAAAAAAAAAPPP
PPPAAAAAAAAADAAAAAAAAAAMDDDDDDDDDDDDDDDDDDDDDDDMAAAADDDDDDDDDAAAAAAAAAAAPPP
PPPAAAAAAAAAAAAAAAAAAAAMMMMMMMMMMMDDDMMMMMMMMMMMAAAAAAAAAAAAAAAAAAAAAAAAPPP
PPPDDDDDDDDDKDDDDDDDDDDXXXXXXXXXXBBBBBXXXXXXXXXXDDDDDDDDDDDDDKDDDDDDDDDDPPP
PPPXXXXXXXXXXXXXXXXXXXXXXXXXXXXXXBBBBBXXXXXXXXXXXXXXXXXXXXXXXXXXXXXXXXXXPPP
PPPXXXXXXXXXXXXXXXXXXXXXXXXXXXXXXBBBBBXXXXXXXXXXXXXXXXXXXXXXXXXXXXXXXXXXPPP
PPPXXXXXXXXXXXXXXXXXXXXXXXXXXXXXXBBBBBXXXXXXXXXXXXXXXXXXXXXXXXXXXXXXXXXXPPP
PPPXXXMMMMMMMMMMMMMMMMMMMMMMMMMMMMMMMMMMMMMMMMMMMMMMMMMMMMMMMMMMMMMMMXXXPPP
PPPXXXMMMMMMMMMMMMMMMMMMMMMMMMMMMMMMMMMMMMMMMMMMMMMMMMMMMMMMMMMMMMMMMXXXPPP
PPPXXXMMMMMMMMMMMMMMMMMMMMMMMMMMMMMMMMMMMMMMMMMMMMMMMMMMMMMMMMMMMMMMMXXXPPP
PPPXXXMMXXXXXXMMMMMMMMMMMMMMMMMMMMMMMMMMMMMMMMMMMMMMMMMMMMMMXXXXXXXMMXXXPPP
PPPXXXMMXXXXXXMMMMMMMMMMMMMMMMMMMMMMMMMMMMMMMMMMMMMMMMMMMMMMXXXXXXXMMXXXPPP
PPPSSSSSSSSSSSMMMMMMMMMMMMMMMMMMMMMMMMMMMMMMMMMMMMMMMMMMMMMMSSSSSSSSSSSSPPP
PPPSSSSSSSSSSSMMMMMMMMMMMMMMMMMMMMMMMMMMMMMMMMMMMMMMMMMMMMMMSSSSSSSSSSSSPPP
PPPXXXMMXXXXXXMMMMMMMMMMMMMMMMMMMMMMMMMMMMMMMMMMMMMMMMMMMMMMXXXXXXXMMXXXPPP
PPPXXXMMXXXXXXMMMMMMMMMMMMMMMMMMMMMMMMMMMMMMMMMMMMMMMMMMMMMMXXXXXXXMMXXXPPP
PPPXXXMMMMMMMMMMMMMMMMMMMMMMMMMMMMMMMMMMMMMMMMMMMMMMMMMMMMMMMMMMMMMMMXXXPPP
PPPXXXMMMMMMMMMMMMMMMMMMMMMMMMMMMMMMMMMMMMMMMMMMMMMMMMMMMMMMMMMMMMMMMXXXPPP
PPPXXXXXXXXXXXXXXXXXXXXXXXXXXXXXXXXXXXXXXXXXXXXXXXXXXXXXXXXXXXXXXXXXXXXXPPP
PPPDDDDDDDDDDDDDDDDDDDDDDDDDDDDDDDDDDDXDDDDDDDDDDDDDDDDDDDDDDDDDDDDDDDDDPPP
PPPKKKKKKKKKKKKKKKKKKKKKKKKKKKKKKKKKKKXKKKKKKKKKKKKKKKKKKKKKKKKKKKKKKKKKPPP
PPPBBBBBBBBBBXXXXXXXXXXXXXXXXXXXXXXXXXXXXXXXXXXXXXXXXXXXXXXXXXAAAAAAAAAAPPP
PPPBBBBBBBBBBXXXXXXXXXXXXXXXXXXXXXXXXXXXXXXXXXXXXXXXXXXXXXXXXXAAAAAAAAAAPPP
PPPBBBBBBBBBBXXXXXXXXXXXXXXXXXXXXXXXXXXXXXXXXXXXXXXXXXXXXXXXXXAAAAAAAAAAPPP
PPPBBBBBBBBBBXXXXXXXXXXXXXXXXXXXXXXXXXXXXXXXXXXXXXXXXXXXXXXXXXAAAAAAAAAAPPP
PPPBBBBBBBBBBXXXXXXXXXXXXXXXXXXXXXXXXXXXXXXXXXXXXXXXXXXXXXXXXXAAAAAAAAAAPPP
PPPPPPPPPPPPPPPPPPPPPPPPPPPPPPPPPPPPPPPPPPPPPPPPPPPPPPPPPPPPPPPPPPPPPPPPPPP
PPPPPPPPPPPPPPPPPPPPPPPPPPPPPPPPPPPPPPPPPPPPPPPPPPPPPPPPPPPPPPPPPPPPPPPPPPP
PPPPPPPPPPPPPPPPPPPPPPPPPPPPPPPPPPPPPPPPPPPPPPPPPPPPPPPPPPPPPPPPPPPPPPPPPPP
