wwwwwwwwwwwww
w.....x.....w
w...........w
w...........w
w...........w
w...........w
w.ww.wwwwww.w
w.....A.....w
wwwwwwwwwwwww
