75
75
PPPPPPPPPPPPPPPPPPPPPPPPPPPPPPPPPPPPPPPPPPPPPPPPPPPPPPPPPPPPPPPPPPPPPPPPPPP
PPPPPPPPPPPPPPPPPPPPPPPPPPPPPPPPPPPPPPPPPPPPPPPPPPPPPPPPPPPPPPPPPPPPPPPPPPP
PPPPPPPPPPPPPPPPPPPPPPPPPPPPPPPPPPPPPPPPPPPPPPPPPPPPPPPPPPPPPPPPPPPPPPPPPPP
PPPTTTTTTTTXTTTTTTTTTTTTTTTPPPPPPPPPPPPPPPPPPPPBBBBBBBBBBXBBBBBBBBBBBBBBPPP
PPPTTTTTTTTTTTTTTTTTTTTTTTTPPPPPPPPPPPPPPPPPPPPBBBBBBBBBBBBBBBBBBBBBBBBBPPP
PPPTTTTTTTTTTTTTTTTTTTTTTTTDDDDDDDDDDDDDDDDDDDDBBBBBBBBBBBBBBBBBBBBBBBBBPPP
PPPTTTTTTTTTTTTTTTTTTTTTTTTDDDDDDDDDDDDDDDDDDDDBBBBBBBBBBBBBBBBBBBBBBBBBPPP
PPPTTTTTTTTTTTTTTTTTTTTTTTTPKKPPPPPPPPPPPPPPPPPBBBBBBBBBBBBBBBBBBBBBBBBBPPP
PPPTTTTTTTTTTTTTTTTTTTTTTTTPKKKKKKKKKKKKKKKKKKPBBBBBBBBBBBBBBBBBBBBBBBBBPPP
PPPTTTTTTTTTTTTTTTTTTTTTTTTPKKKKKKKKKKKKKKKKKKPBBBBBBBBBBBBBBBBBBBBBBBBBPPP
PPPTTTTTTTTTTTTTTTTTTTTTTTTPPPPPPPPPPPPPPPPPPKKBBBBBBBBBBBBBBBBBBBBBBBBBPPP
PPPTTTTTTTTTTTTTTTTTTTTTTTTPKKKKKKKKKKKKKKKKKKPBBBBBBBBBBBBBBBBBBBBBBBBBPPP
PPPTTTTTTTTTTTTTTTTTTTTTTTTPKKKKKKKKKKKKKKKKKKPBBBBBBBBBBBBBBBBBBBBBBBBBPPP
PPPTTTTTTTTTTTTTTTTTTTTTTTTPKKPPPPPPPPPPPPPPPPPBBBBBBBBBBBBBBBBBBBBBBBBBPPP
PPPTTTTTTTTTTTTTTTTTTTTTTTTPKKKKKKKKKKKKKKKKKKPBBBBBBBBBBBBBBBBBBBBBBBBBPPP
PPPTTTTTTTTTTTTTTTTTTTTTTTTPKKKKKKKKKKKKKKKKKKKBBBBBBBBBBBBBBBBBBBBBBBBBPPP
PPPTTTTTTTTTTTTTTTTTTTTTTTTPPPPPPPPPPPPPPPPPKKPBBBBBBBBBBBBBBBBBBBBBBBBBPPP
PPPTTTTTTTTTTTTTTTTTTTTTTTTKKKKKKKKKKKKKKKKKKKPBBBBBBBBBBBBBBBBBBBBBBBBBPPP
PPPTTTTTTTTTTTTTTTTTTTTTTTTKKKKKKKKKKKKKKKKKKKPBBBBBBBBBBBBBBBBBBBBBBBBBPPP
PPPTTTTTTTTTTTTTTTTTTTTTTTTPPPPPPPPPPPPPPPPPPPPBBBBBBBBBBBBBBBBBBBBBBBBBPPP
PPPTTTTTTTTXTTTTTTTTTTTTTTTPPPPPPPPPPPPPPPPPPPPBBBBBBBBBBXBBBBBBBBBBBBBBPPP
PPPPPPPPPSSSPPPPPPPPPPPPPPPPPPPPPPPPPPPPPPPPPPPPPPPPPPPPPSSSPPPPPPPPPPPPPPP
PPPPPPPPPSSSPPPPPPPPPPPPPPPPPPPPPPPPPPPPPPPPPPPPPPPPPPPPPSSSPPPPPPPPPPPPPPP
PPPPPPPPPSSSPPPPPPPPPPPPPPPPPPPPPPPPPPPPPPPPPPPPPPPPPPPPPSSSPPPPPPPPPPPPPPP
PPPPPPPPPSSSPPPPPPPPPPPPPPPPPPPPPPPPPPPPPPPPPPPPPPPPPPPPPSSSPPPPPPPPPPPPPPP
PPPPPPPPPSSSPPPPPPPPPPPPPPPPPPPPPPPPPPPPPPPPPPPPPPPPPPPPPSSSPPPPPPPPPPPPPPP
PPPPPPPPPSSSPPPPPPPPPPPPPPPPPPPPPPPPPPPPPPPPPPPPPPPPPPPPPSSSPPPPPPPPPPPPPPP
PPPPPPPPPSSSPPPPPPPPPPPPPPPPPPPPPPPPPPPPPPPPPPPPPPPPPPPPPSSSPPPPPPPPPPPPPPP
PPPPPPPPPSSSPPPPPPPPPPPPPPPPPPPPPPPPPPPPPPPPPPPPPPPPPPPPPSSSPPPPPPPPPPPPPPP
PPPPPPPPPSSSPPPPPPPPPPPPPPPPPPPPPPPPPPPPPPPPPPPPPPPPPPPPPSSSPPPPPPPPPPPPPPP
PPPPPPPPPSSSPPPPPPPPPPPPPPPPPPPPPPPPPPPPPPPPPPPPPPPPPPPPPSSSPPPPPPPPPPPPPPP
PPPPPPPPPSSSPPPPPPPPPPPPPPPPPPPPPPPPPPPPPPPPPPPPPPPPPPPPPSSSPPPPPPPPPPPPPPP
PPPSSSSSSSSSSSSSSSSSSSSSSSSSSSSSSBBBBBSSSSSSSSSSSSSSSSSSSSSSSSSSSSSSSSSSPPP
PPPSGGGGGGGGGGGGGGGGGGGGGGGGGGGGSBBBBBSGGGGGGGGGGGGGGGGGGGGGGGGGGGGGGGGSPPP
PPPSSSSSSSSSSSSSSSSSSSSSSSSSSSSSSBBBBBSSSSSSSSSSSSSSSSSSSSSSSSSSSSSSSSSSPPP
PPPDDDDDDDDDKDDDDDDDDDDSSSSXXSSSSBBBBBSSSSXXSSSSDDDDDDDDDDDDDKDDDDDDDDDDPPP
PPPTTTTTTTTTTTTTTTTTTTTMMMMMMMMMMMDDDMMMMMMMMMMMTTTTTTTTTTTTTTTTTTTTTTTTPPP
PPPTTTTTTTTTTTTTTTTTTTTMDDDDDDDDDDDDDDDDDDDDDDDMTTTTTTTTTTTTTDDDDDDDDTTTPPP
PPPTTTTTTTTTDTTTTTTTTTTMDDDDDDDDDDDDDDDDDDDDDDDMTTTTTTTTTTTTTTTTTTTTDTTTPPP
PPPTTTTTTTTTDTTTTTTTTTTMMMMMMMMMMMMMMMMMMMMMMDDMTTTTTTTTTTTTTTTTTTTTDTTTPPP
PPPTTTTTTTTTDDDDTTTTTTTMDDDDDDDDDDDDDDDDDDDDDDDMTTTTTTTTTTTTTTTTTTTTDTTTPPP
PPPTTTTTTTTTTTTDTTTTTTTMDDDDDDDDDDDDDDDDDDDDDDDMTTTTDDDDDDDDDDDDDDDDDTTTPPP
PPPTTTTTTTTTDDDDTTTTTTTMDDMMMMMMMMMMMMMMMMMMMMMMTTTTDTTTTTTTTTTTTTTTTTTTPPP
PPPTTTTTTTTTDTTTTTTTTTTMDDDDDDDDDDDDDDDDDDDDDDDMTTTTDTTTTTTTTTTTTTTTTTTTPPP
PPPTTTTTTTTTDDDDTTTTTTTMDDDDDDDDDDDDDDDDDDDDDDDMTTTTDTTTTTTTTTTTTTTTTTTTPPP
PPPTTTTTTTTTTTTDTTTTTTTMMMMMMMMMMMMMMMMMMMMMMDDMTTTTDTTTTTTTTTTTTTTTTTTTPPP
PPPTTTTTTTTTDDDDTTTTTTTMDDDDDDDDDDDDDDDDDDDDDDDMTTTTDTTTTTTTTTTTTTTTTTTTPPP
PPPTTTTTTTTTDTTTTTTTTTTMDDDDDDDDDDDDDDDDDDDDDDDMTTTTDDDDDDDDDTTTTTTTTTTTPPP
PPPTTTTTTTTTTTTTTTTTTTTMMMMMMMMMMMDDDMMMMMMMMMMMTTTTTTTTTTTTTTTTTTTTTTTTPPP
PPPDDDDDDDDDKDDDDDDDDDDSSSSSSSSSSBBBBBSSSSSSSSSSDDDDDDDDDDDDDKDDDDDDDDDDPPP
PPPSSSSSSSSSSSSSSSSSSSSSSSSSSSSSSBBBBBSSSSSSSSSSSSSSSSSSSSSSSSSSSSSSSSSSPPP
PPPSGGGGGGGGGGGGGGGGGGGGGGGGGGGGSBBBBBSGGGGGGGGGGGGGGGGGGGGGGGGGGGGGGGGSPPP
PPPSSSSSSSSSSSSSSSSSSSSSSSSSSSSSSBBBBBSSSSSSSSSSSSSSSSSSSSSSSSSSSSSSSSSSPPP
PPPSSSMMMMMMMMMMMMMMMMMMMMMMMMMMMMMMMMMMMMMMMMMMMMMMMMMMMMMMMMMMMMMMMSSSPPP
PPPSSSMMMMMMMMMMMMMMMMMMMMMMMMMMMMMMMMMMMMMMMMMMMMMMMMMMMMMMMMMMMMMMMSSSPPP
PPPSSSMMMMMMMMMMMMMMMMMMMMMMMMMMMMMMMMMMMMMMMMMMMMMMMMMMMMMMMMMMMMMMMSSSPPP
PPPSSSMMSSSSSSMMMMMMMMMMMMMMMMMMMMMMMMMMMMMMMMMMMMMMMMMMMMMMSSSSSSSMMSSSPPP
PPPSSSMMSSSSSSMMMMMMMMMMMMMMMMMMMMMMMMMMMMMMMMMMMMMMMMMMMMMMSSSSSSSMMSSSPPP
PPPSSSSSSSSSSSMMMMMMMMMMMMMMMMMMMMMMMMMMMMMMMMMMMMMMMMMMMMMMSSSSSSSSSSSSPPP
PPPSSSSSSSSSSSMMMMMMMMMMMMMMMMMMMMMMMMMMMMMMMMMMMMMMMMMMMMMMSSSSSSSSSSSSPPP
PPPSSSMMSSSSSSMMMMMMMMMMMMMMMMMMMMMMMMMMMMMMMMMMMMMMMMMMMMMMSSSSSSSMMSSSPPP
PPPSSSMMSSSSSSMMMMMMMMMMMMMMMMMMMMMMMMMMMMMMMMMMMMMMMMMMMMMMSSSSSSSMMSSSPPP
PPPSSSMMMMMMMMMMMMMMMMMMMMMMMMMMMMMMMMMMMMMMMMMMMMMMMMMMMMMMMMMMMMMMMSSSPPP
PPPSSSMMMMMMMMMMMMMMMMMMMMMMMMMMMMMMMMMMMMMMMMMMMMMMMMMMMMMMMMMMMMMMMSSSPPP
PPPSSSXXXXXXXXXXXXXXXXXXXXXXXXXXXXXXXXXXXXXXXXXXXXXXXXXXXXXXXXXXXXXXXSSSPPP
PPPDDDDDDDDDDDDDDDDDDDDDDDDDDDDDDDDDDDSDDDDDDDDDDDDDDDDDDDDDDDDDDDDDDDDDPPP
PPPKKKKKKKKKKKKKKKKKKKKKKKKKKKKKKKKKKKSKKKKKKKKKKKKKKKKKKKKKKKKKKKKKKKKKPPP
PPPBBBBBBBBBBSSSSSSSSSSSSSSSSSSSSSSSSSSSSSSSSSSSSSSSSSSSSSSSSSTTTTTTTTTTPPP
PPPBBBBBBBBBBSSSSSSSSSSSSSSSSSSSSSSSSSSSSSSSSSSSSSSSSSSSSSSSSSTTTTTTTTTTPPP
PPPBBBBBBBBBBSGGGGGGGGGGGGGGGGGGGGGGGGGGGGGGGGGGGGGGGGGGGGGGSSTTTTTTTTTTPPP
PPPBBBBBBBBBBSSSSSSSSSSSSSSSSSSSSSSSSSSSSSSSSSSSSSSSSSSSSSSSSSTTTTTTTTTTPPP
PPPBBBBBBBBBBSSSSSSSSSSSSSSSSSSSSSSSSSSSSSSSSSSSSSSSSSSSSSSSSSTTTTTTTTTTPPP
PPPPPPPPPPPPPPPPPPPPPPPPPPPPPPPPPPPPPPPPPPPPPPPPPPPPPPPPPPPPPPPPPPPPPPPPPPP
PPPPPPPPPPPPPPPPPPPPPPPPPPPPPPPPPPPPPPPPPPPPPPPPPPPPPPPPPPPPPPPPPPPPPPPPPPP
PPPPPPPPPPPPPPPPPPPPPPPPPPPPPPPPPPPPPPPPPPPPPPPPPPPPPPPPPPPPPPPPPPPPPPPPPPP
