100
100
PPPPPPPPPPPPPPPPPPPPPPPPPPPPPPPPPPPPPPPPPPPPPPPPPPPPPPPPPPPPPPPPPPPPPPPPPPPPPPPPPPPPPPPPPPPPPPPPPPPP
PPPPPPPPPPPPPPPPPPPPPPPPPPPPPPPPPPPPPPPPPPPPPPPPPPPPPPPPPPPPPPPPPPPPPPPPPPPPPPPPPPPPPPPPPPPPPPPPPPPP
PPPPPPPPPPPPPPPPPPPPPPPPPPPPPPPPPPPPPPPPPPPPPPPPPPPPPPPPPPPPPPPPPPPPPPPPPPPPPPPPPPPPPPPPPPPPPPPPPPPP
PPPTTTPPPTTTPPPTTTPPPTTTPPPTTTPPPTTTPPPTTTPPPTPPPTTTPPPTTTPPPTTTPPPTTTPPPTTTPPPTTTPPPTTTPPPTTTPTTPPP
PPPTTTTPPPTTTPPPTTTPPPTTTPPPTTTPPPTTTPPPTTTPPPTPPPTTTPPPTTTPPPTTTPPPTTTPPPTTTPPPTTTPPPTTTPPPTTTPTPPP
PPPTTTTTPPPTTTPPPTTTPPPTTTPPPTTTPPPTTTPPPTTTPPPTPPPTTTPPPTTTPPPTTTPPPTTTPPPTTTPPPTTTPPPTTTPPPTTTTPPP
PPPTTTTTTPPPTTTPPPTTTPPPTTTPPPTTTPPPTTTPPPTTTPPPTPPPTTTPPPTTTPPPTTTPPPTTTPPPTTTPPPTTTPPPTTTPPPTTTPPP
PPPTTTTTTTPPPTTTPPPTTTPPPTTTPPPTTTPPPTTTPPPTTTPPPTPPPTTTPPPTTTPPPTTTPPPTTTPPPTTTPPPTTTPPPTTTPPPTTPPP
PPPTTTTTTTTPPPTTTPPPTTTPPPTTTPPPTTTPPPTTTPPPTTTPPPTPPPTTTPPPTTTPPPTTTPPPTTTPPPTTTPPPTTTPPPTTTPPPTPPP
PPPTTTTTTTTTTTTTTTTTTTTTTTTTTTTTTTTTTTTTTTTTGTTTTTTTTTTTTTTTTTTTTTTTTTTTTTTTTTTTTTTTTTTTTTTTTTTTTPPP
PPPTTTTTTTTTTTTTTTTTTTTTTTTTTTTTTTTTTTTTTTTTTTTTTTTTTTTTTTTTTTTTTTTTTTTTTTTTTTTTTTTTTTTTTTTTTTTTTPPP
PPPTTTTTTTTTTTPPPTTTPPPTTTPPPTTTPPPTTTPPPTTTPPPTTTPPPTPPPTTTPPPTTTPPPTTTPPPTTTPPPTTTPPPTTTPPPTTTTPPP
PPPTTTPPPTTTPPPTTTPPPTTTPPPTTTPPPTTTPPPTTTPPPTPPPTTTPPPTTTPPPTTTPPPTTTPPPTTTPPPTTTPPPTTTPPPTTTPTTPPP
PPPTTTTPPPTTTPPPTTTPPPTTTPPPTTTPPPTTTPPPTTTPPPTPPPTTTPPPTTTPPPTTTPPPTTTPPPTTTPPPTTTPPPTTTPPPTTTPTPPP
PPPTTTTTTTTTTTTTTTTTTTTTTTTTTTTTTTTTTTTTTTTGTTTTTTTTTTTTTTTTTTTTTTTTTTTTTTTTTTTTTTTTTTTTTTTTTTTTTPPP
PPPTTTTTTTTTTTTTTTTTTTTTTTTTTTTTTTTTTTTTTTTTTTTTTTTTTTTTTTTTTTTTTTTTTTTTTTTTTTTTTTTTTTTTTTTTTTTTTPPP
PPPTTTTTTTPPPTTTPPPTTTPPPTTTPPPTTTPPPTTTPPPTTTPPPTPPPTTTPPPTTTPPPTTTPPPTTTPPPTTTPPPTTTPPPTTTPPPTTPPP
PPPTTTTTTTTPPPTTTPPPTTTPPPTTTPPPTTTPPPTTTPPPTTTPPPTPPPTTTPPPTTTPPPTTTPPPTTTPPPTTTPPPTTTPPPTTTPPPTPPP
PPPTTTTTTTTTPPPTTTPPPTTTPPPTTTPPPTTTPPPTTTPPPTTTPPPTPPPTTTPPPTTTPPPTTTPPPTTTPPPTTTPPPTTTPPPTTTPTTPPP
PPPTTTTTTTTTTPPPTTTPPPTTTPPPTTTPPPTTTPPPTTTPPPTTTPPPTPPPTTTPPPTTTPPPTTTPPPTTTPPPTTTPPPTTTPPPTTTPTPPP
PPPTTTTTTTTTTTPPPTTTPPPTTTPPPTTTPPPTTTPPPTTTPPPTTTPPPTPPPTTTPPPTTTPPPTTTPPPTTTPPPTTTPPPTTTPPPTTTTPPP
PPPTTTPPPTTTPPPTTTPPPTTTPPPTTTPPPTTTPPPTTTPPPTPPPTTTPPPTTTPPPTTTPPPTTTPPPTTTPPPTTTPPPTTTPPPTTTPTTPPP
PPPTTTTPPPTTTPPPTTTPPPTTTPPPTTTPPPTTTPPPTTTPPPTPPPTTTPPPTTTPPPTTTPPPTTTPPPTTTPPPTTTPPPTTTPPPTTTPTPPP
PPPTTTTTPPPTTTPPPTTTPPPTTTPPPTTTPPPTTTPPPTTTPPPTPPPTTTPPPTTTPPPTTTPPPTTTPPPTTTPPPTTTPPPTTTPPPTTTTPPP
PPPTTTTTTPPPTTTPPPTTTPPPTTTPPPTTTPPPTTTPPPTTTPPPTPPPTTTPPPTTTPPPTTTPPPTTTPPPTTTPPPTTTPPPTTTPPPTTTPPP
PPPTTTTTTTTTTTTTTTTTTTTTTTTTTTTTTTTTTTTTTTTGTTTTTTTTTTTTTTTTTTTTTTTTTTTTTTTTTTTTTTTTTTTTTTTTTTTTTPPP
PPPTTTTTTTTTTTTTTTTTTTTTTTTTTTTTTTTTTTTTTTTTTTTTTTTTTTTTTTTTTTTTTTTTTTTTTTTTTTTTTTTTTTTTTTTTTTTTTPPP
PPPTTTTTTTTTPPPTTTPPPTTTPPPTTTPPPTTTPPPTTTPPPTTTPPPTPPPTTTPPPTTTPPPTTTPPPTTTPPPTTTPPPTTTPPPTTTPTTPPP
PPPTTTTTTTTTTPPPTTTPPPTTTPPPTTTPPPTTTPPPTTTPPPTTTPPPTPPPTTTPPPTTTPPPTTTPPPTTTPPPTTTPPPTTTPPPTTTPTPPP
PPPTTTTTTTTTTTPPPTTTPPPTTTPPPTTTPPPTTTPPPTTTPPPTTTPPPTPPPTTTPPPTTTPPPTTTPPPTTTPPPTTTPPPTTTPPPTTTTPPP
PPPTTTPPPTTTPPPTTTPPPTTTPPPTTTPPPTTTPPPTTTPPPTPPPTTTPPPTTTPPPTTTPPPTTTPPPTTTPPPTTTPPPTTTPPPTTTPTTPPP
PPPTTTTPPPTTTPPPTTTPPPTTTPPPTTTPPPTTTPPPTTTPPPTPPPTTTPPPTTTPPPTTTPPPTTTPPPTTTPPPTTTPPPTTTPPPTTTPTPPP
PPPTTTTTPPPTTTPPPTTTPPPTTTPPPTTTPPPTTTPPPTTTPPPTPPPTTTPPPTTTPPPTTTPPPTTTPPPTTTPPPTTTPPPTTTPPPTTTTPPP
PPPTTTTTTPPPTTTPPPTTTPPPTTTPPPTTTPPPTTTPPPTTTPPPTPPPTTTPPPTTTPPPTTTPPPTTTPPPTTTPPPTTTPPPTTTPPPTTTPPP
PPPTTTTTTTTTTTTTTTTTTTTTTTTTTTTTTTTTTTTTTTTGTTTTTTTTTTTTTTTTTTTTTTTTTTTTTTTTTTTTTTTTTTTTTTTTTTTTTPPP
PPPTTTTTTTTTTTTTTTTTTTTTTTTTTTTTTTTTTTTTTTTTTTTTTTTTTTTTTTTTTTTTTTTTTTTTTTTTTTTTTTTTTTTTTTTTTTTTTPPP
PPPTTTTTTTTTPPPTTTPPPTTTPPPTTTPPPTTTPPPTTTPPPTTTPPPTPPPTTTPPPTTTPPPTTTPPPTTTPPPTTTPPPTTTPPPTTTPTTPPP
PPPTTTTTTTTTTPPPTTTPPPTTTPPPTTTPPPTTTPPPTTTPPPTTTPPPTPPPTTTPPPTTTPPPTTTPPPTTTPPPTTTPPPTTTPPPTTTPTPPP
PPPTTTTTTTTTTTPPPTTTPPPTTTPPPTTTPPPTTTPPPTTTPPPTTTPPPTPPPTTTPPPTTTPPPTTTPPPTTTPPPTTTPPPTTTPPPTTTTPPP
PPPTTTPPPTTTPPPTTTPPPTTTPPPTTTPPPTTTPPPTTTPPPTPPPTTTPPPTTTPPPTTTPPPTTTPPPTTTPPPTTTPPPTTTPPPTTTPTTPPP
PPPTTTTPPPTTTPPPTTTPPPTTTPPPTTTPPPTTTPPPTTTPPPTPPPTTTPPPTTTPPPTTTPPPTTTPPPTTTPPPTTTPPPTTTPPPTTTPTPPP
PPPTTTTTPPPTTTPPPTTTPPPTTTPPPTTTPPPTTTPPPTTTPPPTPPPTTTPPPTTTPPPTTTPPPTTTPPPTTTPPPTTTPPPTTTPPPTTTTPPP
PPPTTTTTTPPPTTTPPPTTTPPPTTTPPPTTTPPPTTTPPPTTTPPPTPPPTTTPPPTTTPPPTTTPPPTTTPPPTTTPPPTTTPPPTTTPPPTTTPPP
PPPTTTTTTTTTTTTTTTTTTTTTTTTTTTTTTTTTTTTTTTTGTTTTTTTTTTTTTTTTTTTTTTTTTTTTTTTTTTTTTTTTTTTTTTTTTTTTTPPP
PPPTTTTTTTTTTTTTTTTTTTTTTTTTTTTTTTTTTTTTTTTTTTTTTTTTTTTTTTTTTTTTTTTTTTTTTTTTTTTTTTTTTTTTTTTTTTTTTPPP
PPPTTTTTTTTTPPPTTTPPPTTTPPPTTTPPPTTTPPPTTTPPPTTTPPPTPPPTTTPPPTTTPPPTTTPPPTTTPPPTTTPPPTTTPPPTTTPTTPPP
PPPTTTTTTTTTTPPPTTTPPPTTTPPPTTTPPPTTTPPPTTTPPPTTTPPPTPPPTTTPPPTTTPPPTTTPPPTTTPPPTTTPPPTTTPPPTTTPTPPP
PPPTTTTTTTTTTTPPPTTTPPPTTTPPPTTTPPPTTTPPPTTTPPPTTTPPPTPPPTTTPPPTTTPPPTTTPPPTTTPPPTTTPPPTTTPPPTTTTPPP
PPPTTTPPPTTTPPPTTTPPPTTTPPPTTTPPPTTTPPPTTTPPPTPPPTTTPPPTTTPPPTTTPPPTTTPPPTTTPPPTTTPPPTTTPPPTTTPTTPPP
PPPTTTTPPPTTTPPPTTTPPPTTTPPPTTTPPPTTTPPPTTTPPPTPPPTTTPPPTTTPPPTTTPPPTTTPPPTTTPPPTTTPPPTTTPPPTTTPTPPP
PPPTTTTTPPPTTTPPPTTTPPPTTTPPPTTTPPPTTTPPPTTTPPPTPPPTTTPPPTTTPPPTTTPPPTTTPPPTTTPPPTTTPPPTTTPPPTTTTPPP
PPPTTTTTTPPPTTTPPPTTTPPPTTTPPPTTTPPPTTTPPPTTTPPPTPPPTTTPPPTTTPPPTTTPPPTTTPPPTTTPPPTTTPPPTTTPPPTTTPPP
PPPTTTTTTTTTTTTTTTTTTTTTTTTTTTTTTTTTTTTTTTTGTTTTTTTTTTTTTTTTTTTTTTTTTTTTTTTTTTTTTTTTTTTTTTTTTTTTTPPP
PPPTTTTTTTTTTTTTTTTTTTTTTTTTTTTTTTTTTTTTTTTTTTTTTTTTTTTTTTTTTTTTTTTTTTTTTTTTTTTTTTTTTTTTTTTTTTTTTPPP
PPPTTTTTTTTTPPPTTTPPPTTTPPPTTTPPPTTTPPPTTTPPPTTTPPPTPPPTTTPPPTTTPPPTTTPPPTTTPPPTTTPPPTTTPPPTTTPTTPPP
PPPTTTTTTTTTTPPPTTTPPPTTTPPPTTTPPPTTTPPPTTTPPPTTTPPPTPPPTTTPPPTTTPPPTTTPPPTTTPPPTTTPPPTTTPPPTTTPTPPP
PPPTTTTTTTTTTTPPPTTTPPPTTTPPPTTTPPPTTTPPPTTTPPPTTTPPPTPPPTTTPPPTTTPPPTTTPPPTTTPPPTTTPPPTTTPPPTTTTPPP
PPPTTTPPPTTTPPPTTTPPPTTTPPPTTTPPPTTTPPPTTTPPPTPPPTTTPPPTTTPPPTTTPPPTTTPPPTTTPPPTTTPPPTTTPPPTTTPTTPPP
PPPTTTTPPPTTTPPPTTTPPPTTTPPPTTTPPPTTTPPPTTTPPPTPPPTTTPPPTTTPPPTTTPPPTTTPPPTTTPPPTTTPPPTTTPPPTTTPTPPP
PPPTTTTTPPPTTTPPPTTTPPPTTTPPPTTTPPPTTTPPPTTTPPPTPPPTTTPPPTTTPPPTTTPPPTTTPPPTTTPPPTTTPPPTTTPPPTTTTPPP
PPPTTTTTTPPPTTTPPPTTTPPPTTTPPPTTTPPPTTTPPPTTTPPPTPPPTTTPPPTTTPPPTTTPPPTTTPPPTTTPPPTTTPPPTTTPPPTTTPPP
PPPTTTTTTTTTTTTTTTTTTTTTTTTTTTTTTTTTTTTTTTTGTTTTTTTTTTTTTTTTTTTTTTTTTTTTTTTTTTTTTTTTTTTTTTTTTTTTTPPP
PPPTTTTTTTTTTTTTTTTTTTTTTTTTTTTTTTTTTTTTTTTTTTTTTTTTTTTTTTTTTTTTTTTTTTTTTTTTTTTTTTTTTTTTTTTTTTTTTPPP
PPPTTTTTTTTTPPPTTTPPPTTTPPPTTTPPPTTTPPPTTTPPPTTTPPPTPPPTTTPPPTTTPPPTTTPPPTTTPPPTTTPPPTTTPPPTTTPTTPPP
PPPTTTTTTTTTTPPPTTTPPPTTTPPPTTTPPPTTTPPPTTTPPPTTTPPPTPPPTTTPPPTTTPPPTTTPPPTTTPPPTTTPPPTTTPPPTTTPTPPP
PPPTTTTTTTTTTTPPPTTTPPPTTTPPPTTTPPPTTTPPPTTTPPPTTTPPPTPPPTTTPPPTTTPPPTTTPPPTTTPPPTTTPPPTTTPPPTTTTPPP
PPPTTTPPPTTTPPPTTTPPPTTTPPPTTTPPPTTTPPPTTTPPPTPPPTTTPPPTTTPPPTTTPPPTTTPPPTTTPPPTTTPPPTTTPPPTTTPTTPPP
PPPTTTTPPPTTTPPPTTTPPPTTTPPPTTTPPPTTTPPPTTTPPPTPPPTTTPPPTTTPPPTTTPPPTTTPPPTTTPPPTTTPPPTTTPPPTTTPTPPP
PPPTTTTTPPPTTTPPPTTTPPPTTTPPPTTTPPPTTTPPPTTTPPPTPPPTTTPPPTTTPPPTTTPPPTTTPPPTTTPPPTTTPPPTTTPPPTTTTPPP
PPPTTTTTTPPPTTTPPPTTTPPPTTTPPPTTTPPPTTTPPPTTTPPPTPPPTTTPPPTTTPPPTTTPPPTTTPPPTTTPPPTTTPPPTTTPPPTTTPPP
PPPTTTTTTTPPPTTTPPPTTTPPPTTTPPPTTTPPPTTTPPPTTTPPPTPPPTTTPPPTTTPPPTTTPPPTTTPPPTTTPPPTTTPPPTTTPPPTTPPP
PPPTTTTTTTTPPPTTTPPPTTTPPPTTTPPPTTTPPPTTTPPPTTTPPPTPPPTTTPPPTTTPPPTTTPPPTTTPPPTTTPPPTTTPPPTTTPPPTPPP
PPPTTTTTTTTTTTTTTTTTTTTTTTTTTTTTTTTTTTTTTTTGTTTTTTTTTTTTTTTTTTTTTTTTTTTTTTTTTTTTTTTTTTTTTTTTTTTTTPPP
PPPTTTTTTTTTTTTTTTTTTTTTTTTTTTTTTTTTTTTTTTTTTTTTTTTTTTTTTTTTTTTTTTTTTTTTTTTTTTTTTTTTTTTTTTTTTTTTTPPP
PPPTTTTTTTTTTTPPPTTTPPPTTTPPPTTTPPPTTTPPPTTTPPPTTTPPPTPPPTTTPPPTTTPPPTTTPPPTTTPPPTTTPPPTTTPPPTTTTPPP
PPPTTTPPPTTTPPPTTTPPPTTTPPPTTTPPPTTTPPPTTTPPPTPPPTTTPPPTTTPPPTTTPPPTTTPPPTTTPPPTTTPPPTTTPPPTTTPTTPPP
PPPTTTTPPPTTTPPPTTTPPPTTTPPPTTTPPPTTTPPPTTTPPPTPPPTTTPPPTTTPPPTTTPPPTTTPPPTTTPPPTTTPPPTTTPPPTTTPTPPP
PPPTTTTTPPPTTTPPPTTTPPPTTTPPPTTTPPPTTTPPPTTTPPPTPPPTTTPPPTTTPPPTTTPPPTTTPPPTTTPPPTTTPPPTTTPPPTTTTPPP
PPPTTTTTTTTTTTTTTTTTTTTTTTTTTTTTTTTTTTTTTTTGTTTTTTTTTTTTTTTTTTTTTTTTTTTTTTTTTTTTTTTTTTTTTTTTTTTTTPPP
PPPTTTTTTTTPPPTTTPPPTTTPPPTTTPPPTTTPPPTTTPPPTTTPPPTPPPTTTPPPTTTPPPTTTPPPTTTPPPTTTPPPTTTPPPTTTPPPTPPP
PPPTTTTTTTTTPPPTTTPPPTTTPPPTTTPPPTTTPPPTTTPPPTTTPPPTPPPTTTPPPTTTPPPTTTPPPTTTPPPTTTPPPTTTPPPTTTPTTPPP
PPPTTTTTTTTTTPPPTTTPPPTTTPPPTTTPPPTTTPPPTTTPPPTTTPPPTPPPTTTPPPTTTPPPTTTPPPTTTPPPTTTPPPTTTPPPTTTPTPPP
PPPTTTTTTTTTTTPPPTTTPPPTTTPPPTTTPPPTTTPPPTTTPPPTTTPPPTPPPTTTPPPTTTPPPTTTPPPTTTPPPTTTPPPTTTPPPTTTTPPP
PPPTTTPPPTTTPPPTTTPPPTTTPPPTTTPPPTTTPPPTTTPPPTPPPTTTPPPTTTPPPTTTPPPTTTPPPTTTPPPTTTPPPTTTPPPTTTPTTPPP
PPPTTTTPPPTTTPPPTTTPPPTTTPPPTTTPPPTTTPPPTTTPPPTPPPTTTPPPTTTPPPTTTPPPTTTPPPTTTPPPTTTPPPTTTPPPTTTPTPPP
PPPTTTTTPPPTTTPPPTTTPPPTTTPPPTTTPPPTTTPPPTTTPPPTPPPTTTPPPTTTPPPTTTPPPTTTPPPTTTPPPTTTPPPTTTPPPTTTTPPP
PPPTTTTTTPPPTTTPPPTTTPPPTTTPPPTTTPPPTTTPPPTTTPPPTPPPTTTPPPTTTPPPTTTPPPTTTPPPTTTPPPTTTPPPTTTPPPTTTPPP
PPPTTTTTTTTTTTTTTTTTTTTTTTTTTTTTTTTTTTTTTTGTTTTTTTTTTTTTTTTTTTTTTTTTTTTTTTTTTTTTTTTTTTTTTTTTTTTTTPPP
PPPTTTTTTTTTTTTTTTTTTTTTTTTTTTTTTTTTTTTTTTTTTTTTTTTTTTTTTTTTTTTTTTTTTTTTTTTTTTTTTTTTTTTTTTTTTTTTTPPP
PPPTTTTTTTTTPPPTTTPPPTTTPPPTTTPPPTTTPPPTTTPPPTTTPPPTPPPTTTPPPTTTPPPTTTPPPTTTPPPTTTPPPTTTPPPTTTPTTPPP
PPPTTTTTTTTTTPPPTTTPPPTTTPPPTTTPPPTTTPPPTTTPPPTTTPPPTPPPTTTPPPTTTPPPTTTPPPTTTPPPTTTPPPTTTPPPTTTPTPPP
PPPTTTTTTTTTTTPPPTTTPPPTTTPPPTTTPPPTTTPPPTTTPPPTTTPPPTPPPTTTPPPTTTPPPTTTPPPTTTPPPTTTPPPTTTPPPTTTTPPP
PPPTTTPPPTTTPPPTTTPPPTTTPPPTTTPPPTTTPPPTTTPPPTPPPTTTPPPTTTPPPTTTPPPTTTPPPTTTPPPTTTPPPTTTPPPTTTPTTPPP
PPPTTTTPPPTTTPPPTTTPPPTTTPPPTTTPPPTTTPPPTTTPPPTPPPTTTPPPTTTPPPTTTPPPTTTPPPTTTPPPTTTPPPTTTPPPTTTPTPPP
PPPTTTTTPPPTTTPPPTTTPPPTTTPPPTTTPPPTTTPPPTTTPPPTPPPTTTPPPTTTPPPTTTPPPTTTPPPTTTPPPTTTPPPTTTPPPTTTTPPP
PPPTTTTTTPPPTTTPPPTTTPPPTTTPPPTTTPPPTTTPPPTTTPPPTPPPTTTPPPTTTPPPTTTPPPTTTPPPTTTPPPTTTPPPTTTPPPTTTPPP
PPPTTTTTTTTTTTTTTTTTTTTTTTTTTTTTTTTTTTTTTTGTTTTTTTTTTTTTTTTTTTTTTTTTTTTTTTTTTTTTTTTTTTTTTTTTTTTTTPPP
PPPPPPPPPPPPPPPPPPPPPPPPPPPPPPPPPPPPPPPPPPPPPPPPPPPPPPPPPPPPPPPPPPPPPPPPPPPPPPPPPPPPPPPPPPPPPPPPPPPP
PPPPPPPPPPPPPPPPPPPPPPPPPPPPPPPPPPPPPPPPPPPPPPPPPPPPPPPPPPPPPPPPPPPPPPPPPPPPPPPPPPPPPPPPPPPPPPPPPPPP
PPPPPPPPPPPPPPPPPPPPPPPPPPPPPPPPPPPPPPPPPPPPPPPPPPPPPPPPPPPPPPPPPPPPPPPPPPPPPPPPPPPPPPPPPPPPPPPPPPPP
