wwwwwwwwwwwww
w.....x.....w
w...........w
w...........w
w...........w
w...........w
w.wwwwwwwwwww
w.A.........w
wwwwwwwwwwwww
