100
100
PPPPPPPPPPPPPPPPPPPPPPPPPPPPPPPPPPPPPPPPPPPPPPPPPPPPPPPPPPPPPPPPPPPPPPPPPPPPPPPPPPPPPPPPPPPPPPPPPPPP
PPPPPPPPPPPPPPPPPPPPPPPPPPPPPPPPPPPPPPPPPPPPPPPPPPPPPPPPPPPPPPPPPPPPPPPPPPPPPPPPPPPPPPPPPPPPPPPPPPPP
PPPPPPPPPPPPPPPPPPPPPPPPPPPPPPPPPPPPPPPPPPPPPPPPPPPPPPPPPPPPPPPPPPPPPPPPPPPPPPPPPPPPPPPPPPPPPPPPPPPP
PPPTTTTTTTTTTTTTTTTTTTTTTTTAATTSSTTTTTTTTTTTTTTTTTTTTTTTTTTTTSSTTTTTTSSTTTTTTTTTTTTTTTTTTTTTTTTTTPPP
PPPTTTTTTGTTTTTTTTTTTTTTTTTTAATTSSTTTTTTTTTTTTTTTTTTTTTTTTTTTTSSTTTTSSSSTTTTTTTTTTTTTTTTTTTTTTTTTPPP
PPPTTTTTTTTTTSSTTTTTTTTTTTTTAATTSSTTTTTTTTTTTTTTTTTTTTTTTTTTTTTSSTTTSSSSTTTTTTTTTTTTTTTTTTTTTTTTTPPP
PPPTTTSTSTSTSSSSTTTTTTTTTTTAATTTSSTTTTTTTTTTTTTTTTTTTTTTTTGTTTTTSSTTSSSSTTTTTTTTTGTTTTTTTTTTTTTTTPPP
PPPTTSSSSSSSSTTSSTTTTSSTTTAADTTSSTTTTTTTTTTTTTTTTTTTTTTTTTTTTTTSSTTTSSTTTTTTTTTTTTTTTTTTTTTTTTTTTPPP
PPPPPSSPPPPPPPPSSPPPPPPPPPPPPPPPPPPPPPPPPPSSSTSTSTSTTTTTTTTTTTTSSTTSSSSTTTTTTTTTTTTTTTTTTTTTTTTTTPPP
PPPSSTTTTTTTTTTTTSSSSBBSSBSAASBBSBTTTTTTTTTTTTTTTTTTTTTTTTTTTTTTSSSSTSSTTTTTTTTTTTTTTTXTTTTTTTTTTPPP
PPPTTTTTTTTTTTTTTTSTBBBBSSSSSSSSSSSSTTTTTTTTTTTTTTTTTTTTTTTTTTTTTSSSSSSTTTTTTTTTTTTTTTTTTTTTTTTTTPPP
PPPTTTTTTTTTTTTTTTTTBBBBBSBSSBSSBSSSSTTTTTTTTTTTTTTTTTTTTTTTTTTTTSSSSSSTTTTTTTTTTTTTTTTTTTTTTTTTTPPP
PPPTTTTTTTTTTTTTTTTTBBBBBBBBAABSSBTTSSSTTTTTTTTTTTTTTSSSTTTTTTTTSSTSSSSTTTTTTTTTTTTTTTTTTTTTTTTTTPPP
PPPTTTTTTTTTTTTTTTTTBBBBBBBBAABBSSTTTSSSSSTTTTTTSSSSSSSSSSSSTSTSSSTSSTTTTTTTTTTTTTTTTTTTTTTTTTTTTPPP
PPPTTTTTTTGTTTTTTTTTBBBBBBBAABBBSSTTSTSSSSSSSSSSSSSSSSAASSSSSSSSSSSTSTSSSSSSSSSSSTSTTTTSSSSTTTTTTPPP
PPPTTTTTTTTTTTTTTTTTBSSSBBAASSBSSBSSSSSTTTSSSSSSTTTTTSAAAAAASTSSSSSSSSSMSMMMMMMMSSSTTTSSSSSSSTSTSPPP
PPPTTTTTTTTTTTSSSSSSSSSSSSAASSSBSSSSTSTTTTTTTTTTTTTTTAAAAAAAATTSTSSSTSSMSSSSSSSMSSSSSSSTTTTSSSSSSPPP
PPPTTTTTTTTTSSSSSSSSSBBBSSBAABSBSSTTTTTTTTTTTTTGTTTTTAAPPPPPPPPPPPPPPPPPPPPSPPPPPPPPPPPPPPPPPPTSTPPP
PPPTTTTTTTSSSSTTTTTTBBBBBBBBAABSSBTTTTTTTTTTTTTTTTTTTAAAAAAAATTTTTSSSSSMSSSSSSSMSTTTTTSSTTTTTTTTTPPP
PPPTTTTSSSSSTTTTTTTTBBBBBBBBBAABSSTTTTTTTTTTTTTTTTTTTAAAAAAAATTTTTSSTTSMSSSSSSSMSTTTTTTSSSTSTTTTTPPP
PPPSSSSSSSTTTTTTTTTTBBBBBBBBBBBSSBTTTTTTTTTTTTTTTTTTTAAAAAAAATTTTTTSSTSMSSSSSSSMSTTTTTTTSSSSSSTSTPPP
PPPSSSSTTTTTTTTTTTTTBBBBBBBBBBSSBBTTTTTTTTTTTTTTTTTTTAAAAAAAATTTTTTSSTSMSSSSSSSMSTTTTTTTTTSTSSSSSPPP
PPPTTTTTTTTTTTTTTTTTBBBBBBBBBBSSBBTTTTTTTTTTTTTTTTTTTTTTTTTTTTTTTTTTSSSMSSSSSSSMSTTTTTTTTTTTTTSTSPPP
PPPTTTTTTTTTTTTTTTTTTTTTTTTTTTDSSTTTDTTTTTTTTTTTTTTTTTTTTTTTTTTTTTTTSSSMMMMSMMMMSTTTTTTTTTTTTTTTTPPP
PPPTTTTTTTTTTTTTTTTTTTTTTTTTTTTSSTTTTTTTTTTTTTTTTTTTTTTTTTTTTTTTTTTTSSSSSSSSSSSSSTTTTTTTTTTTTTTTTPPP
PPPTTTTTTTGTTTTTTTTTTTTTTTTTTTTSSTTTTTTTTTTTTTGTTTTTTTTTTTTTTTTTTTTSSSSTTTTTTTTTTTTTTTTTTTTTTTTTTPPP
PPPTTTTTTTTTTTTTTTTTTTTTTTTTTTTSSTTTTTBBBBBBBBBBBBBBBBTTTTTTTTTTTTTTTSSTTTTTTTTTTTTGTTTTTTTTTTTTTPPP
PPPTTTTTTTTTTTTTTTTTTTTTTTTTTTSSTTTTTTBBBBBKBBBBBBBBBBTTTTTTTTTTTTTTSSSSTTTTTTTTTTTTTTTTTTTTTTTTTPPP
PPPTTTTTTTTTTTTTTTTTTTTTTTTTTTTSSTTTTTBBBBBBBBBBBBBBBBTTTTTTTTTTTTTTTSSSSTTTDTTTTTTTTTTTTTTTTTTTTPPP
PPPTTTTTTTTTTTTTTTTTTTTTTTTTTTSSTTTTTTBBBBBBBBBBBBBBBBTTTTSSSSSSSSSSSTSSSSTTTTTTTTTTTTTTTTTTTTTTTPPP
PPPMMMMMMMMMMMMMMMTMMMMMMMMMMMMMMMMMMMMMMMMMMMMMMMMMMMMMMMMMMMMMMSMMMMMMMMMMMMMMMMMMMMMMMMMMMMMMMPPP
PPPSSSSSSTTTTTTTTTTTTTTTTTTTSSAATTTTTTBBBBBBBBBKBBBBBBTTTTSMSSSSSSSMSSSTTTSSTTTTTTTTTTTTTTTTTTTTTPPP
PPPTSSTTSSTTTTTTTTTTTTTTTTTTTSSTTTTTTTBBBBBBBBBBBBBBBBTTTTSMSSSSSSSMSSSTTTTSSTTTTTTTTTTGTTTTTTTTTPPP
PPPTTTTTTSSTTTTSSSTTTTTTTTTTSSTTTTTTTTBBBBBBBBBBBBBBBBTTTTSMSSSSSSSMSTSSSTSSTTTTTTTSTTTTTTTTTTTTTPPP
PPPTTTTTTTSSSSSSSSSTTTTTTTTSSAATTTTSTSSBBBBBBBBBBBBBBBSTTTSMSSSSSSSMSTTSSSSSSSTTSTSSSTTTTTTTTTTTTPPP
PPPTTTTTTTTSSSSTTTSSSSSTTTTTSSAATTSSSSSSBBBBBBBBBBBBBSSSSSSMSSSSSSSMSTSSTSSSSSSSSSSTSSTSTTSSSSTTTPPP
PPPTTTTTTTSTTTTTTTTSSSSSTTSTSSTAASSTSTBSSSBBSSBBBBBBSSTSSSSMSSSSSSSSSSSTSSTTTTSSTSTTTSSSSSSSSSSSSPPP
PPPTTTTTTSSSTTTTTTTTTTTSSSSSSTSTSSTTTTBBSSSSSSSSBBBSSBTTTTSMSSSSSSSMSSSSSSTTTTTTTTTTTTSTSSTTTTSSSPPP
PPPSTTTSSSTSSTSTTTTTTTTTSSTSSSSSSTTTTTBBBBSSBBSSSSSSBBTTTTSMMMMMMMMMSTTSSTTTTTTTTTTTTTTTTTTTTTTTTPPP
PPPSSSSSSTTTSSSSSTSTTSTTTTTTTSTSAATTTTBBBBBBBBBBSSSBBBTTTTSSSSSSSSSSSTSSSSTTTTTTTTTTTTTTTTTTTTTTTPPP
PPPTSSSTTTTTTSTSSSSSSSSSSTTTSSTAATTTTTBBBBBBBBBBBBBBBBTTTTTTTTTTTTTTSSTSSSSTTTTTTTTTTGTTTTTTTTTTTPPP
PPPTTTTTTTTTTTTTTSTSSTSSSSTTSSSTAATTTTBBBBBBBBBBBBBBBBTTTTTTTTTTTTTSSTSSTSSTTTTTTTTTTTTTTTTTTTTTTPPP
PPPTTTTTTTTSSSSSSSSSSSTTTSSSSSSSAASTTTTTTTTTTTTTTTTTTTTTTTTTTTTTTTTTSSTSSSSTTTTTTTTTTTTTTTTTTTTTTPPP
PPPTTTTTTTTSMMMMMMMMMSTTTTSSSSTSSSSSTTTTTTTTTTTTTTTTTTTTTTTTTTTTTTTTSSTTSSTTTTTTTTTTTTTTTTTTTTTTTPPP
PPPTTTTTTTTSMSSSSSSSMSTTTTTSSTTTSSTSSSTSTTTTTTTTTTTTTTTTTTTTTTTTTTTSSTTSSTTTTTTTTTTTTTTTTTTTTTTTTPPP
PPPTTTTTTTTSMSSSSSSSMSTTTTTTSSTAATTTSSSSSTSTTSSTSTTTTTTTTTGTTTTTTTTTSSTTSSTTTTTTTTTTTTTTTTTTTTTTTPPP
PPPTTTTTTTTSMSSSSSSSSSTTTTTTTSSAADTTTTSTSSSSSSSSSSTTTTTTTTTTTTTTTTTSSTTSSSSTTTTTTTTTTTTTTTTTTTTTTPPP
PPPTTTTTTTTSMSSSSSSSMSTTTTTTSSTAATTTTTTTTSTSSTTSTSSTTTTTTTTTTTTTTTSSTTTTSSSSTTTTTTTTTTTTTTSSTTTSSPPP
PPPTTTTTTTTSMSSSSSSSMSTTTTTSSTAATTTTTTTTTTTTTTTTTTSSTTTSSTTTTTTTTTTSSTTTTSSTTTTTTTSSTSTTSSSSSTSSSPPP
PPPTTTGTTTTSMSSSSSSSMSTTTTTTSSTTTTTTTTTTTTTTTTTTTTTSSTSSSSTTTTTTTTTTTSTTSSSSSTSSTSSSSSSSSSTTSSSTTPPP
PPPTTTTTTTTSMSSSSSSSMSTTTTTTTSSTTTTTTTTTTTGTTTTTTTTTSSSTTSSTTSSSSTSSSSSSTSSSSSSSSSTTSTSSTTTTTSTTTPPP
PPPTTTTTTTTSMMMMMMMMMSTTTTTTSSTTTTTTTTTTTTTTTTTTTTTTTSTTTTSSSSSSSSSSSTSSSTSSTSTTSTTTTTTTTTTTTTTTTPPP
PPPTTTTTTTTSSSSSSSSSSSBBSSSSSSSSSSSTTTTTTTTTTTTTTTTTTTKTTTTSSTTTTSTTSSTTSSSTTTTTTTTTTTTTTTTTTTTTTPPP
PPPTTTTTTTTTTTTTTTBBBBBBSMMMMMMMMMSTTTTTTTTTTTTTTTTTTTTTTTTTSTTTSTTTSSTTTSSSTTTTTTTTSTTSSTTTTTTTTPPP
PPPTTTKTTTTTTTTTTTBBBBBBSMSSSSSSSMSTTTTTTTTGTTTTTTTTTTTTTTTSSSSSSSTSTSSSSSSSSTTTTTTSSSSSSSTTTTTTTPPP
PPPTTTTTTTTTTTTTTTBBBBBBSMSSSSSSSMSTTTTTTTTTTTTTTTTTTTTTTTSSTSSSBSSSSSBSSBSSSSBSSTSSTSSTTSSTSSTSSPPP
PPPTTTTTTTTTTTTTTTBBBBBBSMSSSSSSSSSTTTTTTTTTTTTTTTTTTTTSTSSTTTBBBBSBBSSBSBSSBSSSSSSTTTTTTTSSSSSSSPPP
PPPTTTTTTTTTTTTTTTBBBBBBSMSSSSSSSMSTTTTTTTTTTTTTTTSTTTSSSSTTTTBBBBBBBSSBBSSBBBSBTSTTTTTTTTTSTTSTTPPP
PPPTTTTTTTTTTTTTTTBBBBBBSMSSSSSSSMSTTTTTTTTTTTTTTSSSSSSTSTTTTTBBBBBBSSBBSSBBBBBBTTTTTTTTTKTTTTTTTPPP
PPPTTTTTGTTTTTTTTTBBBBBBSMSSSSSSSMSTTTTTTTTTTTTSSSTSSSTTTTTTTTBBBBBBSSBSSSSBBBBBTTTTTTTTTTTTTTTTTPPP
PPPTTTTTTTTTTTTTTTBBBBBBSMSSSSSSSMSTTTTTTTSSTSSSSTTTTTTTTTTTTTBBBBBSSBSSBSSBBBBBTTTTTTTTTTTTTTTTTPPP
PPPTTTTTTTTTTTTTTTBBBBBBSMMMMMMMMMSTTTTTTSSSSSSTTTTTTTTTTTTTTTBBBBBBBSSBSSBBBBBBTTTTTTTTTTTTTTTTTPPP
PPPTTTTTTGTTTTTTTTTTTTTTSSSSSSSSSSSSTTTSSSTTSTTTTTTTTTTTTTTTTTBBBBBBSSSSSSBBBBBBTTTTTTTTTTTTTTTTTPPP
PPPTTTTTTTTTTTTTTTTTTTTTTTTTSSTTTTSSSTSSSTTTTTTTTTTTTTTTTTTTTTBBBBBSSBBSSBBBBBBBTTTTTTTTTTTTTTTTTPPP
PPPTBBBBBBBBBBBBBBTSTSTTTSTSSAATSSSTSSSTTTTTTTTTTTTTTTTTTTTTTTBBBBBSSBSSSSBBBBBBTTTTTTTTTTTTTTTTTPPP
PPPTBBBBSBBBSSBBBBSSSSSTSSSSAASSSSTTTSTTTTTTTTTTTTTTTTTTTTTTTTBBBBBSSBBSSSSBBBBBTTTTTTTTTTTTTTTTTPPP
PPPTBBBSSSBSSSSBBSSTSTSSSSSAATSSTTTTTATTTTTTTTTTTTTTTTTTTGTTTTBBBBBSSBSSBSSBBBBBTTTTTTTTTTTTGTTTTPPP
PPPTSBSSBSSSBBSSSSTTTTTSSSTTAATTTTTTAAAATTTTTTTTTATTTTTTTTTTTTBBBBSSBSSBSSBBBBBBTTTTTTTTTTTTTTTTTPPP
PPPSSSSBBBSBBBBSSBTTTTTSSTAAAAATTATAATAAATTTTTTAAAATTTTTTTTTTTBBBBBSSSSBSSBBBBBBTTTTTTTTTTTTTTTTTPPP
PPPSBSBBBBBBABBBBBTATAATSSAATAAAAAAATTTTAATTAAAAATAAAATTTTTTTABAABBBBSSSSBBBBBBBTTTTTTTTTTTTTTTTTPPP
PPPTBBBBBBBAAAABBAAAAAASSTTSSATAATATTTTTTAAAAAATTTTAAAAATTAAAAAAAABBSSSSSSBBSBBBTTTTTTTTTTTTTTTTTPPP
PPPTBBBBBAAABAAAAAATATTTTSSSSSTTTTTTTTTTTTAATTTTTTTTTTAATAAAATABBABBSSSSSSSSSSBATTSTTTTTTTTTTTTTTPPP
PPPTABAAAAABBBBAABTTTSTSSSSTTSSTTTTTTTTTTTTTTTTTTTTTTTTSSASTTTBBBBSSSSSSSSSSBSSASSSSTTATTTTTSTTTAPPP
PPPAAAAAABBBBBBBSSTSSSSSSTTTTTSSTTTTTTTGTTTTTTTTTTTTTSSSSSSSTSSSTSSSSSTSSTTTTTSSSSTSSSATTTTSSSTAAPPP
PPPABABBBBBBSSBSSSSSSTSTSSTTTAASSTTTTTTTTTTTTTTSTTTSSSSTTSTSSSSSSSTSSDSSTTTTTTTSTTTTSSSSSSSSTSSATPPP
PPPTBBBBBBSSSSSSBBSTTTTTSSTTAATTSSSTTTTTTTTSTSSSSSSSSTTTTTTTSTTTSTSSTTTSSTTTTTTTTTTTTTSSSSSTTTSSTPPP
PPPTBBBBBSSSBBSTBBTKTTTTTSSTTAATTSSSTSSTSSSSSSSTSSSTTTTTTTTTTTTTTTTSSTTTSSTTTTTTTTTTTTTTTTTTTTTSSPPP
PPPTSBBBSSBBBBBBBBTTTTTTSSTTAATTTTTSSSSSSSSTSTTTTTTTTTTTTTTTTTTTTTTSSTTTSSTTTTTTTTTTTTTTTTTTTTTTSPPP
PPPMMMMSMMMMMMMMMMMMMMMMMSSMAMMMMMMMMMMMMMMMMMMMMMMMMMMMMMMMMMMMMSSMMMMMMMMMMMMMMMMMMMMMMMMMMMMMMPPP
PPPSTSSSTTTTTTTTTTTTTTTTTSSTAATTTTTTTTTTTTTTTTTTTTTTTTTTTTTTTTTTTSSTTTTTSSTTTTTTTTTTTTTTTTTTTTTTTPPP
PPPTTTTTTTTTTTTTTTTTTTTTTSSAATTTTTTTTGTTTTTTTTTSSSSSSSSSSSTTTTTTTTSSTTTSSTTTTTTTTTTTTTTTTTTTTTTTTPPP
PPPTTTTTTTTTTTTTTTTTTTTTTSSTTTTTTTTTTTTTTTTTTTTSMMMMMMMMMSTTTTTTTTTSSTTTSSTTTTTTTTTTTTTTTTTTTTTTTPPP
PPPTTTTTTTTTTTTTTTTTTTTTTTSSTTTTTTTTTTTTTTTTTTTSMSSSSSSSMSTTTTTTTTTSSTTTSSTTTTTTTTTTTTKTTTTTTTTTTPPP
PPPTTTTTTTTTTTTTTTTTTTTTTTTSSTTTTTTTTAAAAAAAATTSMSSSSSSSMSTTTTTTTTTTSSTSSTTTTTTTTTTTTTTTTTTTTTTTTPPP
PPPTTTTTTTTTTTTTTTTTTTTTTTAASSTTTTTTTAAAAAAAATTSSSSSSSSSMSTTTTTTTTTTTSSTSSTTTTTTTTTTTTTTTTTTTTTTTPPP
PPPTTTTTTTTTTTTTTTTTTTTTTTTAASSTTTTTTAAAAAAAATTSMSSSSSSSMSTTTTGTTTTTSSTSSSSTTTTTTTTTTTTTTTTGTTTTTPPP
PPPTTTTTTTTTTTTTTTTTTTTTTTTTSSTTTTTTTAAAAAAAATTSMSSSSSSSMSTTTTTTTTTTSSTTSSSSTTTTTTTTTTTTTTTTTTTTTPPP
PPPTTTTTTTTTTTTTTTTTTTTTTTTSSTTTTTTTTAAAXAAAATTSMSSSSSSSMSTTTTTTTTTTTSSSSTSSTTTTTTTTTTTTTTTTTTTTTPPP
PPPTTTTTTTTTTTTTTTTTTTTTTTSSTTTTTTTTTAAAAAAAATTSMSSSSSSSMSTTTTTTTTTTTSSTTSSTTTTTTTTTTTTTTTTTTTTTTPPP
PPPTTTTTTTTTTTTTTTTTTTTTTTSSTTTTTTTTTAAAAAAAATTSMMMMMMMMMSTTTTTTTTTTTSSTTTSSTTTTTTTTTTTTTTTTTTTTTPPP
PPPTTTTTTTTTTTTTTTTTTTTTTTTSSTTTTTTTTAAAAAAAATTSSSSSSSSSSSTTTTTTTTTTSSSSTTSSTTTTTTTTTTTTTTTTTTTTTPPP
PPPTTTTTTTTTTTTTTTTTTTTTTTSSTTTTTTTTTTTTTTTTTTTTTTTTTTTTTTTTTTTTTTTTSSSSTSSTTTTTTTTTTTTTTTTTTTTTTPPP
PPPTTTTTTTTTTTTTTTTTTTTTTTTSSTTTTTTTTTTTTTTTTTTTTTTTTTTTTTTTTTTTTTTSSTSSSSTTTTTTTTTTTTTTTTTTTTTTTPPP
PPPTTTTTTTTTTTTTTTTTTTTTTTTTSSTTTTTTTTTTTTTTTTTTTTTTTTTTTTTTTTTTTTSSTSSTSSTTTTTTTTTTTTTTTTTTTTTTTPPP
PPPTTTTTGTTTTTTTTTTTTTTTTTTAASSTTTTTTTTTTTTTTTTTTTTTTTTTTTTTTTTTTTSSTSSSSTTTTTTTTTTTTTTTTTTTTTTTTPPP
PPPTTTTTTTTTTTTTTTTTTTTTTTTAASSTTTTTTTTTTTTTTTTTTTTTTTTTTTTTTTTTTTSSTTSSTTTTTTTTTTTTTTTTTTTTTTTTTPPP
PPPTTTTTTTTTTTTTTTTTTTTTTTTTSSTTTTTTTTTTTTTTTTKTTTTTTTTTTTTTTTTTTTTSSTSSTTTTTTTTTTTTTTTTTTTTTTTTTPPP
PPPPPPPPPPPPPPPPPPPPPPPPPPPPPPPPPPPPPPPPPPPPPPPPPPPPPPPPPPPPPPPPPPPPPPPPPPPPPPPPPPPPPPPPPPPPPPPPPPPP
PPPPPPPPPPPPPPPPPPPPPPPPPPPPPPPPPPPPPPPPPPPPPPPPPPPPPPPPPPPPPPPPPPPPPPPPPPPPPPPPPPPPPPPPPPPPPPPPPPPP
PPPPPPPPPPPPPPPPPPPPPPPPPPPPPPPPPPPPPPPPPPPPPPPPPPPPPPPPPPPPPPPPPPPPPPPPPPPPPPPPPPPPPPPPPPPPPPPPPPPP
