50
50
PPPPPPPPPPPPPPPPPPPPPPPPPPPPPPPPPPPPPPPPPPPPPPPPPP
PPPPPPPPPPPPPPPPPPPPPPPPPPPPPPPPPPPPPPPPPPPPPPPPPP
PPPPPPPPPPPPPPPPPPPPPPPPPPPPPPPPPPPPPPPPPPPPPPPPPP
PPPTTTBBBBBBBBBBBSSBBBBBTTTTTTTSSTTTTSSTTTTSSTTPPP
PPPTTTBBBBBBSBBBSBSSSBBBTTTTTTSSTTTTSSTTTTTSSTTPPP
PPPSTSBBBBSSSSSSSSSSSSSBTTTTSTTSTASAASSAAASSTSTPPP
PPPSSSSBSSSSSSSSBSSSBSSSTSTSSSSSSSSSSSSSSASSSSSPPP
PPPTSSSSSSBBSSSBBBSSBSSSSSSSSSSTSSASSSSSSSSTSTSPPP
PPPTSSSSSBSSSSSSBSSBSSSSSTSTSTTSSAAAASSAASSBBBSPPP
PPPSSTSBSSSSSBBSSBSSSBBSTTTTTTSSTAAAASSAAASSBBSPPP
PPPSTTBBBSBBBBBBSSDBBBBBTTTTTTSSTAAAASSAAASSBBSPPP
PPPTTTBBBBBBBBBBBSSBBBBBTTTTTSSTTAASSSAAASSBBBSPPP
PPPTTTBBBBBBBBBBBBSSBBBBTTTTTSSTTSSSSSAASSAASSSPPP
PPPTTTBBBBBBBBBBBSSSSSSSTSSSSTSSSSSAASSSSAAASSSPPP
PPPTTTBBBBBBBBBBBSSBSSSSSSSSSSSTSAAAAASSSSAAABSPPP
PPPTTTBBBBBBBBBBBBSSBBBBSTTTSSTTTTTTTTSSBSSBBBSPPP
PPPTTTBBBBBBBBBBBBBSSBBBTTTSSTTTTTTTTSSTBSSBBBSPPP
PPPTTTBBBBBBBBBBBBSSBBBBTTSSTTTTTTTTTTSSBBSSBBSPPP
PPPTTTBBBBBBBBBBBBBSSBBBTSSTKTTTTTTTTTSSBSSBBBSPPP
PPPTTTBBBBBBBBBBBBDBSSBBTTSSTTTTTTTTKSSTBBSSBBBPPP
PPPTTTTTTTTTTTTTTTTTTSSTTSSTTTTTTTTTTSSTBBSSBBBPPP
PPPTTTTTTTTTTTTTTTTTTSSTTTSSTTTTTTTTTTSSBSSBBBKPPP
PPPTTTTTTTTTTTTTTTTTTDSSTTTSSTTTTTTTTSSTSSAABBBPPP
PPPTTTTTTTTTTTTTTTTTTTSSTTSSTTTTTTTTTSSTBSSAABBPPP
PPPTTTTTTTTTTTTTTTTTTTTSSSSTTTTTTTTTTSSTBBSSBBBPPP
PPPTTTTKTTTTTTTTTTTTTTSSSSTTTTTTTTTTTSSTBSSBBBBPPP
PPPTTTTTTTTTTTTTTTTTDSSTTSSTTTTTTTTTSSTTSSAASSSPPP
PPPTTTTTTTTTTTTTTTTTTSSTTSSTTTTTTTTTTSSSSTTAASSPPP
PPPAAAAAAAAAAAAATTTTTSSTXTSSTTTTTTTBBBSSBBBAABBPPP
PPPAAAAAAAAAAAAATTTTTTSSTSSTTTTTTTTBBSSSSBAABBBPPP
PPPAAAAAAAAAAAAATTTTTTTTSSTTTTTTTTTBBBSSBBAABBBPPP
PPPAAAAAAAAAAAAATTTTTTTSSSSTTTTTTTTBBBSSBBAABBBPPP
PPPAAAAAAAAAAAAATTTTTTTTSSTTTTTTTTTBBBBSSAABBBBPPP
PPPAAAAAAAAAAAAATTTTTTTTTSSTTTTTTTTBBBSSBAABBBBPPP
PPPAAAAAAAAAAAAATTTTTTTTTSSTTTTTTTTBBBSSBAABBBBPPP
PPPAAAAAAAAAAAAATTTTTTTTSSTTTTTTTTTBBSSBAABBSSBPPP
PPPAAAAAAAAAAAAATTTTTTTTTSSTTTTTTTTBBSSAASSSSSSPPP
PPPAAAAAASAAAAAATTTTTTTTSSSTSTTTTTTBSSBSSSSSBBSPPP
PPPAASAASSSSAAAATTTTTTTSSSSSSSTTSTTSSBSSSAABBBBPPP
PPPSSSSSSASSSAAATTSSSSTTSSASASSSSSSSBSSBBAAABBBPPP
PPPSSASSAAAASSAASSSSSSSSSAABABSSBSSSSSSSAABAABBPPP
PPPAAAAAAAAAASSSSSABBKSSBABBBBBBBBBBSBBSSBBBAAAPPP
PPPTKTTTTATAATSSTTABBBBSSBBBBBBBBBBBSSSSTTTTTAAPPP
PPPTTTTAAAAAATTTTTTBBBBSSBBBBBBBBBBBBSSAATTTTTTPPP
PPPTATTTATATTTTTTTTBBBBBSSBBBBBBBBBBBSSAABBBBBBPPP
PPPAAAATTTTTTTTTTTTBBBBBBSSBBBBBBBBBSSSSBBBBBBBPPP
PPPATATTTTTTTTTTTTTBBBBBSSSSKBBBBBBSSBBSSBBBBBBPPP
PPPPPPPPPPPPPPPPPPPPPPPPPPPPPPPPPPPPPPPPPPPPPPPPPP
PPPPPPPPPPPPPPPPPPPPPPPPPPPPPPPPPPPPPPPPPPPPPPPPPP
PPPPPPPPPPPPPPPPPPPPPPPPPPPPPPPPPPPPPPPPPPPPPPPPPP
