75
75
PPPPPPPPPPPPPPPPPPPPPPPPPPPPPPPPPPPPPPPPPPPPPPPPPPPPPPPPPPPPPPPPPPPPPPPPPPP
PPPPPPPPPPPPPPPPPPPPPPPPPPPPPPPPPPPPPPPPPPPPPPPPPPPPPPPPPPPPPPPPPPPPPPPPPPP
PPPPPPPPPPPPPPPPPPPPPPPPPPPPPPPPPPPPPPPPPPPPPPPPPPPPPPPPPPPPPPPPPPPPPPPPPPP
PPPAAAAAAAAXAAAAAAAAAAAAAAAPPPPPPPPPPPPPPPPPPPPBBBBBBBBBBXBBBBBBBBBBBBBBPPP
PPPAAAAAAAAAAAAAAAAAAAAAAAAPPPPPPPPPPPPPPPPPPPPBBBBBBBBBBBBBBBBBBBBBBBBBPPP
PPPAAAAAAAAAAAAAAAAAAAAAAAADDDDDDDDDDDDDDDDDDDDBBBBBBBBBBBBBBBBBBBBBBBBBPPP
PPPAAAAAAAAAAAAAAAAAAAAAAAADDDDDDDDDDDDDDDDDDDDBBBBBBBBBBBBBBBBBBBBBBBBBPPP
PPPAAAAAAAAAAAAAAAAAAAAAAAAPKKPPPPPPPPPPPPPPPPPBBBBBBBBBBBBBBBBBBBBBBBBBPPP
PPPAAAAAAAAAAAAAAAAAAAAAAAAPKKKKKKKKKKKKKKKKKKPBBBBBBBBBBBBBBBBBBBBBBBBBPPP
PPPAAAAAAAAAAAAAAAAAAAAAAAAPKKKKKKKKKKKKKKKKKKPBBBBBBBBBBBBBBBBBBBBBBBBBPPP
PPPAAAAAAAAAAAAAAAAAAAAAAAAPPPPPPPPPPPPPPPPPPKKBBBBBBBBBBBBBBBBBBBBBBBBBPPP
PPPAAAAAAAAAAAAAAAAAAAAAAAAPKKKKKKKKKKKKKKKKKKPBBBBBBBBBBBBBBBBBBBBBBBBBPPP
PPPAAAAAAAAAAAAAAAAAAAAAAAAPKKKKKKKKKKKKKKKKKKPBBBBBBBBBBBBBBBBBBBBBBBBBPPP
PPPAAAAAAAAAAAAAAAAAAAAAAAAPKKPPPPPPPPPPPPPPPPPBBBBBBBBBBBBBBBBBBBBBBBBBPPP
PPPAAAAAAAAAAAAAAAAAAAAAAAAPKKKKKKKKKKKKKKKKKKPBBBBBBBBBBBBBBBBBBBBBBBBBPPP
PPPAAAAAAAAAAAAAAAAAAAAAAAAPKKKKKKKKKKKKKKKKKKKBBBBBBBBBBBBBBBBBBBBBBBBBPPP
PPPAAAAAAAAAAAAAAAAAAAAAAAAPPPPPPPPPPPPPPPPPKKPBBBBBBBBBBBBBBBBBBBBBBBBBPPP
PPPAAAAAAAAAAAAAAAAAAAAAAAAKKKKKKKKKKKKKKKKKKKPBBBBBBBBBBBBBBBBBBBBBBBBBPPP
PPPAAAAAAAAAAAAAAAAAAAAAAAAKKKKKKKKKKKKKKKKKKKPBBBBBBBBBBBBBBBBBBBBBBBBBPPP
PPPAAAAAAAAAAAAAAAAAAAAAAAAPPPPPPPPPPPPPPPPPPPPBBBBBBBBBBBBBBBBBBBBBBBBBPPP
PPPAAAAAAAAXAAAAAAAAAAAAAAAPPPPPPPPPPPPPPPPPPPPBBBBBBBBBBXBBBBBBBBBBBBBBPPP
PPPPPPPPPSSSPPPPPPPPPPPPPPPPPPPPPPPPPPPPPPPPPPPPPPPPPPPPPSSSPPPPPPPPPPPPPPP
PPPPPPPPPSSSPPPPPPPPPPPPPPPPPPPPPPPPPPPPPPPPPPPPPPPPPPPPPSSSPPPPPPPPPPPPPPP
PPPPPPPPPSSSPPPPPPPPPPPPPPPPPPPPPPPPPPPPPPPPPPPPPPPPPPPPPSSSPPPPPPPPPPPPPPP
PPPPPPPPPSSSPPPPPPPPPPPPPPPPPPPPPPPPPPPPPPPPPPPPPPPPPPPPPSSSPPPPPPPPPPPPPPP
PPPPPPPPPSSSPPPPPPPPPPPPPPPPPPPPPPPPPPPPPPPPPPPPPPPPPPPPPSSSPPPPPPPPPPPPPPP
PPPPPPPPPSSSPPPPPPPPPPPPPPPPPPPPPPPPPPPPPPPPPPPPPPPPPPPPPSSSPPPPPPPPPPPPPPP
PPPPPPPPPSSSPPPPPPPPPPPPPPPPPPPPPPPPPPPPPPPPPPPPPPPPPPPPPSSSPPPPPPPPPPPPPPP
PPPPPPPPPSSSPPPPPPPPPPPPPPPPPPPPPPPPPPPPPPPPPPPPPPPPPPPPPSSSPPPPPPPPPPPPPPP
PPPPPPPPPSSSPPPPPPPPPPPPPPPPPPPPPPPPPPPPPPPPPPPPPPPPPPPPPSSSPPPPPPPPPPPPPPP
PPPPPPPPPSSSPPPPPPPPPPPPPPPPPPPPPPPPPPPPPPPPPPPPPPPPPPPPPSSSPPPPPPPPPPPPPPP
PPPPPPPPPSSSPPPPPPPPPPPPPPPPPPPPPPPPPPPPPPPPPPPPPPPPPPPPPSSSPPPPPPPPPPPPPPP
PPPSSSSSSSSSSSSSSSSSSSSSSSSSSSSSSBBBBBSSSSSSSSSSSSSSSSSSSSSSSSSSSSSSSSSSPPP
PPPSSSSSSSSSSSSSSSSSSSSSSSSSSSSSSBBBBBSSSSSSSSSSSSSSSSSSSSSSSSSSSSSSSSSSPPP
PPPSSSSSSSSSSSSSSSSSSSSSSSSSSSSSSBBBBBSSSSSSSSSSSSSSSSSSSSSSSSSSSSSSSSSSPPP
PPPDDDDDDDDDKDDDDDDDDDDSSSSXXSSSSBBBBBSSSSXXSSSSDDDDDDDDDDDDDKDDDDDDDDDDPPP
PPPAAAAAAAAAAAAAAAAAAAAMMMMMMMMMMMDDDMMMMMMMMMMMAAAAAAAAAAAAAAAAAAAAAAAAPPP
PPPAAAAAAAAAAAAAAAAAAAAMDDDDDDDDDDDDDDDDDDDDDDDMAAAAAAAAAAAAADDDDDDDDAAAPPP
PPPAAAAAAAAADAAAAAAAAAAMDDDDDDDDDDDDDDDDDDDDDDDMAAAAAAAAAAAAAAAAAAAADAAAPPP
PPPAAAAAAAAADAAAAAAAAAAMMMMMMMMMMMMMMMMMMMMMMDDMAAAAAAAAAAAAAAAAAAAADAAAPPP
PPPAAAAAAAAADDDDAAAAAAAMDDDDDDDDDDDDDDDDDDDDDDDMAAAAAAAAAAAAAAAAAAAADAAAPPP
PPPAAAAAAAAAAAADAAAAAAAMDDDDDDDDDDDDDDDDDDDDDDDMAAAADDDDDDDDDDDDDDDDDAAAPPP
PPPAAAAAAAAADDDDAAAAAAAMDDMMMMMMMMMMMMMMMMMMMMMMAAAADAAAAAAAAAAAAAAAAAAAPPP
PPPAAAAAAAAADAAAAAAAAAAMDDDDDDDDDDDDDDDDDDDDDDDMAAAADAAAAAAAAAAAAAAAAAAAPPP
PPPAAAAAAAAADDDDAAAAAAAMDDDDDDDDDDDDDDDDDDDDDDDMAAAADAAAAAAAAAAAAAAAAAAAPPP
PPPAAAAAAAAAAAADAAAAAAAMMMMMMMMMMMMMMMMMMMMMMDDMAAAADAAAAAAAAAAAAAAAAAAAPPP
PPPAAAAAAAAADDDDAAAAAAAMDDDDDDDDDDDDDDDDDDDDDDDMAAAADAAAAAAAAAAAAAAAAAAAPPP
PPPAAAAAAAAADAAAAAAAAAAMDDDDDDDDDDDDDDDDDDDDDDDMAAAADDDDDDDDDAAAAAAAAAAAPPP
PPPAAAAAAAAAAAAAAAAAAAAMMMMMMMMMMMDDDMMMMMMMMMMMAAAAAAAAAAAAAAAAAAAAAAAAPPP
PPPDDDDDDDDDKDDDDDDDDDDSSSSSSSSSSBBBBBSSSSSSSSSSDDDDDDDDDDDDDKDDDDDDDDDDPPP
PPPSSSSSSSSSSSSSSSSSSSSSSSSSSSSSSBBBBBSSSSSSSSSSSSSSSSSSSSSSSSSSSSSSSSSSPPP
PPPSSSSSSSSSSSSSSSSSSSSSSSSSSSSSSBBBBBSSSSSSSSSSSSSSSSSSSSSSSSSSSSSSSSSSPPP
PPPSSSSSSSSSSSSSSSSSSSSSSSSSSSSSSBBBBBSSSSSSSSSSSSSSSSSSSSSSSSSSSSSSSSSSPPP
PPPSSSMMMMMMMMMMMMMMMMMMMMMMMMMMMMMMMMMMMMMMMMMMMMMMMMMMMMMMMMMMMMMMMSSSPPP
PPPSSSMMMMMMMMMMMMMMMMMMMMMMMMMMMMMMMMMMMMMMMMMMMMMMMMMMMMMMMMMMMMMMMSSSPPP
PPPSSSMMMMMMMMMMMMMMMMMMMMMMMMMMMMMMMMMMMMMMMMMMMMMMMMMMMMMMMMMMMMMMMSSSPPP
PPPSSSMMSSSSSSMMMMMMMMMMMMMMMMMMMMMMMMMMMMMMMMMMMMMMMMMMMMMMSSSSSSSMMSSSPPP
PPPSSSMMSSSSSSMMMMMMMMMMMMMMMMMMMMMMMMMMMMMMMMMMMMMMMMMMMMMMSSSSSSSMMSSSPPP
PPPSSSSSSSSSSSMMMMMMMMMMMMMMMMMMMMMMMMMMMMMMMMMMMMMMMMMMMMMMSSSSSSSSSSSSPPP
PPPSSSSSSSSSSSMMMMMMMMMMMMMMMMMMMMMMMMMMMMMMMMMMMMMMMMMMMMMMSSSSSSSSSSSSPPP
PPPSSSMMSSSSSSMMMMMMMMMMMMMMMMMMMMMMMMMMMMMMMMMMMMMMMMMMMMMMSSSSSSSMMSSSPPP
PPPSSSMMSSSSSSMMMMMMMMMMMMMMMMMMMMMMMMMMMMMMMMMMMMMMMMMMMMMMSSSSSSSMMSSSPPP
PPPSSSMMMMMMMMMMMMMMMMMMMMMMMMMMMMMMMMMMMMMMMMMMMMMMMMMMMMMMMMMMMMMMMSSSPPP
PPPSSSMMMMMMMMMMMMMMMMMMMMMMMMMMMMMMMMMMMMMMMMMMMMMMMMMMMMMMMMMMMMMMMSSSPPP
PPPSSSXXXXXXXXXXXXXXXXXXXXXXXXXXXXXXXXXXXXXXXXXXXXXXXXXXXXXXXXXXXXXXXSSSPPP
PPPDDDDDDDDDDDDDDDDDDDDDDDDDDDDDDDDDDDSDDDDDDDDDDDDDDDDDDDDDDDDDDDDDDDDDPPP
PPPKKKKKKKKKKKKKKKKKKKKKKKKKKKKKKKKKKKSKKKKKKKKKKKKKKKKKKKKKKKKKKKKKKKKKPPP
PPPBBBBBBBBBBSSSSSSSSSSSSSSSSSSSSSSSSSSSSSSSSSSSSSSSSSSSSSSSSSAAAAAAAAAAPPP
PPPBBBBBBBBBBSSSSSSSSSSSSSSSSSSSSSSSSSSSSSSSSSSSSSSSSSSSSSSSSSAAAAAAAAAAPPP
PPPBBBBBBBBBBSSSSSSSSSSSSSSSSSSSSSSSSSSSSSSSSSSSSSSSSSSSSSSSSSAAAAAAAAAAPPP
PPPBBBBBBBBBBSSSSSSSSSSSSSSSSSSSSSSSSSSSSSSSSSSSSSSSSSSSSSSSSSAAAAAAAAAAPPP
PPPBBBBBBBBBBSSSSSSSSSSSSSSSSSSSSSSSSSSSSSSSSSSSSSSSSSSSSSSSSSAAAAAAAAAAPPP
PPPPPPPPPPPPPPPPPPPPPPPPPPPPPPPPPPPPPPPPPPPPPPPPPPPPPPPPPPPPPPPPPPPPPPPPPPP
PPPPPPPPPPPPPPPPPPPPPPPPPPPPPPPPPPPPPPPPPPPPPPPPPPPPPPPPPPPPPPPPPPPPPPPPPPP
PPPPPPPPPPPPPPPPPPPPPPPPPPPPPPPPPPPPPPPPPPPPPPPPPPPPPPPPPPPPPPPPPPPPPPPPPPP
