30
30
PPPPPPPPPPPPPPPPPPPPPPPPPPPPPP
PPPPPPPPPPPPPPPPPPPPPPPPPPPPPP
PPPPPPPPPPPPPPPPPPPPPPPPPPPPPP
PPPSSSSSSSSSSSMMMMMMMMMMMMMPPP
PPPSSMMMMMMMMSMMMMMMMMMMMMMPPP
PPPSSSABSMMMMSMMMMMMMAAAMMMPPP
PPPMMMMMSSSMMSMMMMMMMADAMMMPPP
PPPMMMMMSSSMMSMMMMMMMMSMMMMPPP
PPPMMMMMSSSMMSMMMMMMMMSMSSSPPP
PPPMMMMMMMMMMSBBBBBBBBSASSSPPP
PPPMMMMMMMMMMSMMMMMMMMSMSSSPPP
PPPMMMMMMMMMMSMMMMMMMBSBMMMPPP
PPPMMMMMMMMMMSMMMMMMMBKBMMMPPP
PPPMMMMMMMMMMSMMMMSSSMMMMMMPPP
PPPMMMMMMMMMMSMMMMSDSMMMMMMPPP
PPPMMMMMMAAAMSMMMMSSSMMMMMMPPP
PPPMMMMMMAXSSSMMMMMSMMMMMMMPPP
PPPMMMMMMAAAMSMMMMMSMMMMAAAPPP
PPPMMMMMMMMMMSAAAAASAAAAAAAPPP
PPPMMMMMMMMMMSMMMMMSMMMMAAAPPP
PPPMMMMMMMMMMSBBBBBSMMMMMMMPPP
PPPMMMMMMBBBMSMMMMSSSMMMMMMPPP
PPPMMMMMMBKSSSMMMMSKSMMMMMMPPP
PPPMMMMMMBBBMSMMMMSSSMMMMMMPPP
PPPMMMMMMMMMMSMMMMMMMMMMMMMPPP
PPPMMMMMMMMMSSSMMMMMMMMMMMMPPP
PPPMMMMMMMMMSSSMMMMMMMMMMMMPPP
PPPPPPPPPPPPPPPPPPPPPPPPPPPPPP
PPPPPPPPPPPPPPPPPPPPPPPPPPPPPP
PPPPPPPPPPPPPPPPPPPPPPPPPPPPPP
